"","ensemble_id","PV_losses","cases_per_100k","start_date","end_date","labor_supply_level","duration","intensity","q_cases"
"1","1",12502.8264295661,61815.3489302685,66,110,0.671272235224023,44,14.464021650143,"Q3"
"2","10",12147.0605476309,61825.7197808437,52,103,0.944395329337567,51,2.83583820378408,"Q4"
"3","100",12364.5980970818,61819.7085343024,70,103,0.708324457053095,33,9.62529291724786,"Q4"
"4","1000",13615.7025896885,61795.4228757388,59,95,0.418112731305882,36,20.9479416729882,"Q2"
"5","1001",12404.0713441271,61816.6228844448,62,96,0.60811813455075,34,13.3239834252745,"Q3"
"6","1002",18391.5418581113,61711.9001602345,51,104,0.107593626715243,53,47.2975377840921,"Q1"
"7","1003",14029.5288138994,61785.9026864871,69,108,0.422971341526136,39,22.5041176804807,"Q2"
"8","1004",16873.8473776208,61729.5926323393,59,110,0.241349276155233,51,38.6911869160831,"Q1"
"9","1005",12342.6305716135,61820.2297071721,57,101,0.760145846288651,44,10.5535827632993,"Q4"
"10","1006",15287.7184136905,61739.8633265157,47,123,0.466656405711547,76,40.5341131659225,"Q1"
"11","1007",12128.4055372163,61825.8687340598,54,94,0.944121221313253,40,2.23515114746988,"Q4"
"12","1008",12446.2081368406,61819.3015201275,59,126,0.829613182460889,67,11.4159167751204,"Q4"
"13","1009",14435.3327095978,61772.5182826614,71,119,0.450890612788498,48,26.3572505861521,"Q2"
"14","101",12409.7979798394,61811.8444313282,45,80,0.50493949255906,35,17.3271177604329,"Q3"
"15","1010",12859.8361163081,61804.3513581451,70,118,0.573947626864538,48,20.4505139105022,"Q3"
"16","1011",15457.559813945,61755.9066518671,48,101,0.372339326655492,53,33.2660156872589,"Q2"
"17","1012",12383.7219739362,61817.3107408107,57,95,0.645172578981146,38,13.4834419987164,"Q3"
"18","1013",18989.9391625352,61692.6784672761,46,104,0.132100927643478,58,50.3381461966783,"Q1"
"19","1014",16245.2370750309,61756.6498541041,55,96,0.17516591376625,41,33.8181975355837,"Q2"
"20","1015",12973.066732989,61803.2723097329,88,129,0.585797700798139,41,16.9822942672763,"Q3"
"21","1016",12558.3838501055,61804.4177514856,44,98,0.536231962032616,54,25.0434740502387,"Q3"
"22","1017",18591.7691759877,61705.2994053831,47,102,0.126784934429452,55,48.0268286063801,"Q1"
"23","1018",12392.4481186819,61819.2072550435,58,107,0.760911837220192,49,11.7153199762106,"Q4"
"24","1019",16630.734683402,61742.97748431,60,105,0.193873230135068,45,36.2757046439219,"Q1"
"25","102",12321.8520159603,61818.3927434817,55,87,0.617568749934435,32,12.2378000020981,"Q3"
"26","1020",12301.7315416751,61822.6333477523,63,116,0.865796463564038,53,7.11278743110597,"Q4"
"27","1021",18108.9078078057,61679.4938560774,53,121,0.288359022000805,68,48.3915865039453,"Q1"
"28","1022",12321.250797749,61822.6924383359,58,128,0.894477450987324,70,7.38657843088731,"Q4"
"29","1023",13714.3056326623,61786.3937681064,61,113,0.495583593845367,52,26.2296531200409,"Q2"
"30","1024",12191.5736703295,61824.615088216,49,102,0.908319596666843,53,4.85906137665734,"Q4"
"31","1025",15785.6633215558,61747.1356191602,68,116,0.329387099249288,48,32.1894192360342,"Q2"
"32","1026",12625.4494806991,61813.1225121731,54,127,0.748726915335283,73,18.3429351805244,"Q3"
"33","1027",16545.5496254414,61729.4633909918,65,117,0.291708761593327,52,36.831144397147,"Q1"
"34","1028",12256.8270953424,61820.649436982,43,89,0.768554509617388,46,10.6464925576001,"Q4"
"35","1029",17878.0573632315,61720.7808114595,53,104,0.132987581426278,51,44.2176333472598,"Q1"
"36","103",12302.3947647745,61821.4849653249,56,100,0.793876863317564,44,9.06941801402718,"Q4"
"37","1030",17473.9003434232,61659.0679178438,89,152,0.343906302237883,63,41.3339029590134,"Q1"
"38","1031",12531.138050791,61812.8630992735,49,110,0.682005896000192,61,19.3976403439883,"Q3"
"39","1032",18651.8555167907,61691.8568721275,67,121,0.106776745058596,54,48.2340557668358,"Q1"
"40","1033",15956.6145697832,61767.7547468147,55,91,0.127670568646863,36,31.4038595287129,"Q2"
"41","1034",12318.7638261777,61817.6119179805,50,86,0.621152249630541,36,13.6385190133005,"Q3"
"42","1035",16387.3459172471,61752.9965828197,60,101,0.163198992144316,41,34.308841322083,"Q2"
"43","1036",16087.7015077909,61769.9324683376,58,92,0.067122048465535,34,31.7178503521718,"Q2"
"44","1037",13163.6111311391,61801.1112093362,61,100,0.483429005835205,39,20.146268772427,"Q3"
"45","1038",12174.1061840503,61825.4797732012,57,114,0.941789693199098,57,3.31798748765141,"Q4"
"46","1039",17821.3309850479,61720.6145307544,68,115,0.0933217909187078,47,42.6138758268207,"Q1"
"47","104",18628.9925138662,61667.3004128148,56,123,0.244323377264664,67,50.6303337232675,"Q1"
"48","1040",15280.1974014782,61764.1390844352,67,108,0.307525800773874,41,28.3914421682712,"Q2"
"49","1041",12467.520466673,61812.6701945054,56,95,0.552584211807698,39,17.4492157394998,"Q3"
"50","1042",12261.6593986074,61823.2731027259,48,112,0.888242994435132,64,7.15244835615158,"Q4"
"51","1043",18011.3216760711,61699.7309640391,64,119,0.183130354387686,55,44.9278305086773,"Q1"
"52","1044",18337.5082257621,61709.0259256595,52,106,0.126614279579371,54,47.162828902714,"Q1"
"53","1045",12132.9485911904,61825.9396873755,52,100,0.951025214511901,48,2.35078970342875,"Q4"
"54","1046",12585.0624910405,61810.5336735472,52,111,0.644058210076764,59,21.0005656054709,"Q3"
"55","1047",13282.0713274944,61789.3285257043,56,125,0.557300904067233,69,30.5462376193609,"Q2"
"56","1048",13131.151569805,61797.3951530738,57,109,0.523351518670097,52,24.785721029155,"Q3"
"57","1049",17697.8003120659,61681.1586373091,52,125,0.346662940690294,73,47.6936053296085,"Q1"
"58","105",17462.5452757262,61701.3149256201,63,122,0.274495862424374,59,42.804744116962,"Q1"
"59","1050",12199.9682593453,61825.5470636628,55,132,0.951659608399495,77,3.72221015323885,"Q4"
"60","1051",13117.542394988,61799.6286931803,49,93,0.478003343101591,44,22.96785290353,"Q3"
"61","1052",12174.3343722621,61826.3224652736,66,142,0.966637972509488,76,2.53551408927888,"Q4"
"62","1053",12924.1670611686,61798.8643962563,57,123,0.584048926597461,66,27.4527708445676,"Q3"
"63","1054",12257.4927087143,61821.7916352347,56,88,0.73840595362708,32,8.37100948393345,"Q4"
"64","1055",20822.676223768,61638.2742922024,70,132,0.00326086976565421,62,61.7978260745294,"Q1"
"65","1056",12308.7684098542,61821.5012170574,54,103,0.810995837440714,49,9.261203965405,"Q4"
"66","1057",12215.1407539444,61825.3134907216,59,135,0.948137503117323,76,3.94154976308346,"Q4"
"67","1058",17489.6841213641,61739.1302148928,58,102,0.0680754862260073,44,41.0046786060557,"Q1"
"68","1059",13607.826342386,61797.4609769465,51,84,0.382885548053309,33,20.3647769142408,"Q3"
"69","106",12574.4164963605,61811.9568878627,69,111,0.604324893094599,42,16.6183544900268,"Q3"
"70","1060",13078.3621599987,61802.4361627012,49,87,0.458868674002588,38,20.5629903879017,"Q3"
"71","1061",12264.6665491972,61823.9306314431,58,126,0.915530710481107,68,5.74391168728471,"Q4"
"72","1062",17103.5662779732,61731.4282545036,60,108,0.181977460626513,48,39.2650818899274,"Q1"
"73","1063",12251.7915200361,61822.6355344731,54,95,0.815045207971707,41,7.58314647316001,"Q4"
"74","1064",12114.9717981479,61826.3224652736,60,115,0.977284200955182,55,1.24936894746497,"Q4"
"75","1065",12174.1762728796,61826.0411785143,61,132,0.960535014048219,71,2.80201400257647,"Q4"
"76","1066",12243.2100595248,61819.4975383615,41,84,0.728042570175603,43,11.6941694824491,"Q4"
"77","1067",16149.8489000635,61763.8600843399,57,94,0.120471880538389,37,32.5425404200796,"Q2"
"78","1068",16822.66736238,61757.9232981248,58,96,0.0402495693415403,38,36.4705163650215,"Q2"
"79","1069",12212.555193204,61823.7759956554,50,96,0.867189790820703,46,6.10926962224767,"Q4"
"80","107",14579.6794818675,61785.0767820139,43,76,0.329974767751992,33,22.1108326641843,"Q2"
"81","1070",12871.1981792661,61801.0703997795,48,99,0.512913041515276,51,24.8414348827209,"Q3"
"82","1071",12304.8875029321,61817.753565763,48,85,0.631742137949914,37,13.6255408958532,"Q3"
"83","1072",12744.9690878676,61809.1376382807,58,132,0.715496188029647,74,21.0532820858061,"Q3"
"84","1073",12637.5506177769,61808.8589561,60,113,0.608019260922447,53,20.7749791711103,"Q3"
"85","1074",12430.5462059566,61818.4041143455,61,111,0.75450376002118,50,12.274811998941,"Q3"
"86","1075",20084.748671885,61643.1891922427,40,109,0.202398233581334,69,55.0345218828879,"Q1"
"87","1076",12520.3444741639,61815.6627835926,54,117,0.745528451865539,63,16.031707532471,"Q3"
"88","1077",12217.3086531436,61822.6954184382,49,85,0.788892247714102,36,7.59987908229232,"Q4"
"89","1078",14488.7342241303,61782.2237709446,54,92,0.337081523612142,38,25.1909021027386,"Q2"
"90","1079",12797.1951639453,61802.4410007806,55,114,0.568547257687896,59,25.4557117964141,"Q3"
"91","108",16203.1940332399,61771.0824569808,66,98,0.00875909463502467,32,31.7197089716792,"Q2"
"92","1080",14403.5922091172,61767.767211975,61,122,0.487653255229816,61,31.2531514309812,"Q2"
"93","1081",16622.922974886,61718.6422549526,58,120,0.354093349305913,62,40.0462123430334,"Q1"
"94","1082",12328.3782839399,61819.968279548,58,95,0.713991733035073,37,10.5823058777023,"Q4"
"95","1083",12798.8780693925,61808.8741002024,56,88,0.472326424438506,32,16.8855544179678,"Q3"
"96","1084",14084.7973783673,61785.5328981334,66,105,0.41053780936636,39,22.9890254347119,"Q2"
"97","1085",18617.2563245556,61695.6898283943,67,120,0.0955605318304151,53,47.935291812988,"Q1"
"98","1086",17428.8346768088,61720.2432967905,45,100,0.251444509718567,55,41.1705519654788,"Q1"
"99","1087",12473.6719517643,61813.6733284058,61,96,0.552325971890241,35,15.6685909838416,"Q3"
"100","1088",12647.822783033,61811.5131544843,57,123,0.70589591935277,66,19.4108693227172,"Q3"
"101","1089",12719.1833798648,61810.1585537478,60,131,0.719515255419537,71,19.9144168652128,"Q3"
"102","109",19701.6919227633,61672.1418102701,44,106,0.127807169687003,62,54.0759554794058,"Q1"
"103","1090",12208.6402183007,61820.9108712955,44,77,0.707218490773812,33,9.66178980446421,"Q4"
"104","1091",17479.9978183845,61681.5394557912,56,130,0.368702603271231,74,46.7160073579289,"Q1"
"105","1092",16510.9692359645,61755.6705668326,48,89,0.151252010837197,41,34.7986675556749,"Q2"
"106","1093",12194.8666062267,61824.9684901228,58,112,0.925186642212793,54,4.03992132050917,"Q4"
"107","1094",12502.3621272342,61811.1121661255,49,102,0.610678228316829,53,20.6340538992081,"Q3"
"108","1095",13207.3478786185,61800.7299653073,70,107,0.493467492051423,37,18.7417027940974,"Q3"
"109","1096",15941.749887135,61768.2676541924,59,94,0.114730532979593,35,30.9844313457143,"Q2"
"110","1097",17779.928967573,61704.0229592319,50,110,0.248601315775886,60,45.0839210534468,"Q1"
"111","1098",12110.7899065406,61826.3224652736,67,105,0.970424978993833,38,1.12385079823434,"Q4"
"112","1099",12096.3226724442,61826.3224652736,54,91,0.976601340109482,37,0.865750415949151,"Q4"
"113","11",13291.9142804582,61789.1963339058,57,126,0.559692007256672,69,30.3812514992896,"Q2"
"114","110",22445.1183839867,61567.549438087,56,133,0.044977605342865,77,73.5367243885994,"Q1"
"115","1100",22320.9114823373,61579.0050258098,54,130,0.0425919813569635,76,72.7630094168708,"Q1"
"116","1101",16022.2510529959,61766.6200295661,57,93,0.119833436561748,36,31.6859962837771,"Q2"
"117","1102",13683.000484092,61794.1117490046,57,94,0.41380737000145,37,21.6891273099463,"Q2"
"118","1103",13092.080981399,61798.4329741711,65,117,0.549659102922305,52,23.4177266480401,"Q3"
"119","1104",12274.6481860568,61822.4889364828,47,106,0.858764709206298,59,8.33288215682842,"Q4"
"120","1105",12750.8014676992,61803.3339461245,54,114,0.57557564554736,60,25.4654612671584,"Q3"
"121","1106",12148.6284925949,61825.2306609773,53,89,0.907372152432799,36,3.33460251241922,"Q4"
"122","1107",15602.0738513267,61757.5015207659,51,99,0.321486703120172,48,32.5686382502317,"Q2"
"123","1108",19676.8051223784,61558.5650700387,88,160,0.241637983359396,72,54.6020651981235,"Q1"
"124","1109",16951.1503833186,61735.5241786105,53,102,0.20485369162634,49,38.9621691103093,"Q1"
"125","111",12357.1511952249,61816.5710720656,53,89,0.599319841479883,36,14.4244857067242,"Q3"
"126","1110",18922.3779365678,61673.0069661812,53,117,0.190895239822567,64,51.7827046513557,"Q1"
"127","1111",14661.3533342898,61776.0064297691,49,93,0.370300316484645,44,27.7067860746756,"Q2"
"128","1112",13743.4734164312,61789.5889397778,64,107,0.461609869264066,43,23.1507756216452,"Q2"
"129","1113",14145.3390296642,61767.0686030919,57,131,0.527296835090965,74,34.9800342032686,"Q2"
"130","1114",12396.8035800906,61820.5232589783,63,123,0.838561163749546,60,9.68633017502725,"Q4"
"131","1115",12119.1603576647,61825.5951704574,46,79,0.920983216026798,33,2.60755387111567,"Q4"
"132","1116",13400.6539925923,61800.5719315676,55,87,0.402301355963573,32,19.1263566091657,"Q3"
"133","1117",12503.3688319966,61817.2721047203,70,123,0.767002019099891,53,12.3488929877058,"Q3"
"134","1118",22458.1551030892,61592.1945334829,45,120,0.0389968818053603,75,72.075233864598,"Q1"
"135","1119",12230.5996833027,61822.5388665988,48,89,0.805208048550412,41,7.98647000943311,"Q4"
"136","112",12454.1945259113,61813.3853239816,39,71,0.587160826195031,32,13.210853561759,"Q3"
"137","1120",12353.5443171096,61816.2367558769,52,88,0.588807543274015,36,14.8029284421355,"Q3"
"138","1121",12280.1700283892,61822.7435676302,79,111,0.821323690004647,32,5.7176419198513,"Q4"
"139","1122",12637.8072314641,61810.1731903491,53,88,0.496733833802864,35,17.6143158168998,"Q3"
"140","1123",12319.7116319797,61822.47269717,63,122,0.875661777099594,59,7.33595515112393,"Q4"
"141","1124",18940.9045842542,61679.3141051314,52,114,0.168038416886702,62,51.5816181530245,"Q1"
"142","1125",12840.6736225706,61803.2139495983,56,130,0.64987513772212,74,25.9092398085631,"Q3"
"143","1126",14229.7041970432,61779.8431101254,54,102,0.428016343386844,48,27.4552155174315,"Q2"
"144","1127",17938.6638556916,61715.2214673251,63,113,0.120974405901507,50,43.9512797049247,"Q1"
"145","1128",15015.1456453184,61781.9314884834,43,74,0.240814825985581,31,23.534740394447,"Q2"
"146","1129",13666.4083626694,61781.4067114942,48,113,0.503596806433052,65,32.2662075818516,"Q2"
"147","113",12148.9968129644,61826.0462991118,66,118,0.957932055927813,52,2.18753309175372,"Q4"
"148","1130",21367.4632417681,61618.5532667991,64,131,0.017396419076249,67,65.8344399218913,"Q1"
"149","1131",12547.1998611174,61811.6035429456,60,106,0.600188056472689,46,18.3913494022563,"Q3"
"150","1132",16016.0977321225,61754.4976677215,52,97,0.253774798708037,45,33.5801340581384,"Q2"
"151","1133",12383.2232521057,61813.9348462386,46,92,0.611130054341629,46,17.8880175002851,"Q3"
"152","1134",12165.9774014287,61824.6666465008,46,90,0.894818163942546,44,4.62800078652799,"Q4"
"153","1135",12317.0656584853,61821.2707846592,66,102,0.767307978589088,36,8.37691277079284,"Q4"
"154","1136",12420.13926065,61815.5039219639,57,96,0.610535917105153,39,15.189099232899,"Q3"
"155","1137",13255.2228953739,61788.952714607,50,119,0.540189173305407,69,31.7269470419269,"Q2"
"156","1138",19224.7491700738,61648.8889039413,63,129,0.194624235620722,66,53.1548004490323,"Q1"
"157","1139",12120.6931852882,61826.3224652736,56,124,0.979548477102071,68,1.39070355705917,"Q4"
"158","114",12383.2458664637,61820.9620340881,56,125,0.858864143723622,69,9.73837408307008,"Q4"
"159","1140",19723.1245163205,61622.1133229409,53,129,0.238418752094731,76,57.8801748408005,"Q1"
"160","1141",14883.792267026,61774.1711392886,61,100,0.31731452094391,39,26.6247336831875,"Q2"
"161","1142",12373.3894475657,61820.6286110754,55,116,0.830775446491316,61,10.3226977640297,"Q4"
"162","1143",12971.0637961427,61796.9314718715,56,130,0.603338754968718,74,29.3529321323149,"Q2"
"163","1144",12512.3165792518,61813.920909204,71,105,0.578733237227425,34,14.3230699342676,"Q3"
"164","1145",18141.8246920808,61700.6979354525,64,118,0.157078021438792,54,45.5177868423052,"Q1"
"165","1146",16859.1275998095,61724.8950025212,54,110,0.286124311387539,56,39.9770385622978,"Q1"
"166","1147",18049.5199993559,61730.3656434806,54,101,0.0478751908522099,47,44.7498660299461,"Q1"
"167","1148",13934.912731816,61791.5275644333,57,92,0.372773458249867,35,21.9529289612547,"Q2"
"168","1149",17746.1310753928,61706.6666992441,53,111,0.230107004288584,58,44.6537937512621,"Q1"
"169","115",12724.8768418065,61809.7393953524,62,130,0.706827550660819,68,19.9357265550643,"Q3"
"170","1150",12974.6654509351,61799.5828355899,65,140,0.651366407750174,75,26.1475194187369,"Q3"
"171","1151",15281.2099323893,61771.5913438384,46,85,0.284660193137825,39,27.8982524676248,"Q2"
"172","1152",12622.6967392117,61809.5822347845,57,97,0.531134669668972,40,18.7546132132411,"Q3"
"173","1153",12190.6508124997,61824.5500619979,47,101,0.906961806118488,54,5.02406246960163,"Q4"
"174","1154",14269.2072544955,61773.7349300832,68,121,0.481049251975492,53,27.5043896452989,"Q2"
"175","1155",14128.6036680326,61778.1868780085,55,109,0.463145250687376,54,28.9901564628817,"Q2"
"176","1156",15569.0404010207,61769.2652460304,56,93,0.200980564346537,37,29.5637191191781,"Q2"
"177","1157",12332.063177646,61820.6792018588,64,101,0.750119762727991,37,9.24556877906434,"Q4"
"178","1158",16756.0428015984,61755.612216381,58,97,0.072204572847113,39,36.1840216589626,"Q2"
"179","1159",12272.6620765449,61823.5451475409,64,121,0.896862988593057,57,5.87880965019576,"Q4"
"180","116",12533.5361591288,61817.7276435817,69,145,0.848943528719246,76,11.4802918173373,"Q3"
"181","1160",14735.0613608986,61783.9279522017,56,88,0.237251884536818,32,24.4079396948218,"Q2"
"182","1161",14832.0858332402,61775.5216162275,51,92,0.329841012600809,41,27.4765184833668,"Q2"
"183","1162",12093.3768428716,61826.3224652736,62,101,0.985442138044164,39,0.56775661627762,"Q4"
"184","1163",12124.4136096254,61826.0254302137,67,100,0.950556355528533,33,1.6316402675584,"Q4"
"185","1164",16998.3197055721,61719.7451753703,58,114,0.278844357468188,56,40.3847159817815,"Q1"
"186","1165",12208.8811172862,61824.2189264744,56,101,0.885723713086918,45,5.14243291108869,"Q4"
"187","1166",12274.5381577071,61821.672678416,54,93,0.772444906178862,39,8.87464865902439,"Q4"
"188","1167",12089.4451609535,61826.3224652736,38,92,0.987263740273193,54,0.687758025247604,"Q4"
"189","1168",12645.892664497,61810.0037219135,60,117,0.647997239604592,57,20.0641573425382,"Q3"
"190","1169",19058.6471071507,61712.0322538582,51,103,0.0160540381912142,52,51.1651900140569,"Q1"
"191","117",12367.8976796453,61820.8560754599,50,119,0.849230762105435,69,10.403077414725,"Q4"
"192","1170",12102.2086515541,61826.3224652736,48,121,0.988046618178487,73,0.872596872970462,"Q4"
"193","1171",16638.0200205352,61751.8057177345,35,75,0.240335810929537,40,30.3865675628185,"Q2"
"194","1172",12201.0962319551,61825.142945321,57,121,0.937610311200842,64,3.9929400831461,"Q4"
"195","1173",12176.8811781521,61824.9494367444,55,100,0.911533971549943,45,3.98097128025256,"Q4"
"196","1174",16679.5523629018,61731.6966180904,63,113,0.255287162493914,50,37.2356418753043,"Q1"
"197","1175",12644.4603333487,61807.6855824917,49,115,0.638193021062762,66,23.8792606098577,"Q3"
"198","1176",12898.3175984085,61802.8312624208,75,137,0.644468936370686,62,22.0429259450175,"Q3"
"199","1177",17681.0860263627,61700.3508389416,55,116,0.264642009744421,61,44.8568374055903,"Q1"
"200","1178",12292.4325270856,61822.7910978729,56,115,0.874699641484767,59,7.39272115239874,"Q4"
"201","1179",12244.1098736163,61822.9574116539,60,95,0.81028452469036,35,6.64004163583741,"Q4"
"202","118",12558.8726966585,61815.1025940059,73,122,0.71697019576095,49,13.8684604077134,"Q3"
"203","1180",12104.3989395677,61826.3224652736,67,100,0.971380760893226,33,0.944434890523553,"Q4"
"204","1181",17268.3425043236,61713.7150862033,81,128,0.178428472019732,47,38.6138618150726,"Q1"
"205","1182",12476.5390493465,61814.7948272963,63,103,0.621821199310943,40,15.1271520275623,"Q3"
"206","1183",17578.5869296862,61693.9984056646,64,125,0.284236560575664,61,43.6615698048845,"Q1"
"207","1184",15882.311711924,61735.2420005279,56,119,0.403575712814927,63,37.5747300926596,"Q1"
"208","1185",12534.9962479929,61812.9461266653,59,91,0.517309892224148,32,15.4460834488273,"Q3"
"209","1186",12381.4092988793,61816.9091084721,51,95,0.664332153042778,44,14.7693852661178,"Q3"
"210","1187",12484.2647152247,61815.5372727041,56,108,0.695628943387419,52,15.8272949438542,"Q3"
"211","1188",12101.6364798289,61826.3224652736,56,98,0.976294826716185,42,0.995617277920246,"Q4"
"212","1189",12081.7683390635,61826.3224652736,53,91,0.995969005394727,38,0.153177795000374,"Q4"
"213","119",14864.9071105256,61774.3743118054,50,92,0.33644150220789,42,27.8694569072686,"Q2"
"214","1190",14337.6402483533,61778.1282925595,53,101,0.41884083673358,48,27.8956398367882,"Q2"
"215","1191",14717.4450252013,61769.9072624974,51,102,0.406653565121815,51,30.2606681787875,"Q2"
"216","1192",16613.1755274657,61763.1887348703,52,89,0.0473943457473069,37,35.2464092073496,"Q2"
"217","1193",12757.8732500912,61807.4701204586,48,84,0.477208198281005,36,18.8205048618838,"Q3"
"218","1194",16220.5606539532,61732.4049030703,51,112,0.36646292032674,61,38.6457618600689,"Q1"
"219","1195",12510.764874526,61816.81170127,69,121,0.751837763935328,52,12.904436275363,"Q3"
"220","1196",20388.9665257507,61638.7525302988,59,125,0.089042253093794,66,60.1232112958096,"Q1"
"221","1197",13855.606924112,61774.0855784804,55,129,0.535193276125938,74,34.3956975666806,"Q2"
"222","1198",12444.586377247,61818.8148588416,67,119,0.785066576907411,52,11.1765380008146,"Q3"
"223","1199",19283.2030463819,61652.3898810156,53,122,0.210621057078242,69,54.4671470616013,"Q1"
"224","12",12111.26890186,61826.3224652736,59,118,0.981307342415676,59,1.10286679747514,"Q4"
"225","120",14952.1837372158,61759.2208296693,66,120,0.43565005552955,54,30.4748970014043,"Q2"
"226","1200",18021.7854008331,61697.0570032775,54,114,0.226732535520568,60,46.3960478687659,"Q1"
"227","1201",12101.4069680396,61826.3224652736,52,95,0.974684108048677,43,1.08858335390687,"Q4"
"228","1202",18572.9123578503,61662.3671164922,59,127,0.26017986331135,68,50.3077692948282,"Q1"
"229","1203",12319.4846883975,61820.5154461851,61,96,0.7248930928763,35,9.62874174932949,"Q4"
"230","1204",13383.9670986919,61788.1527292785,63,129,0.563253422733396,66,28.8252740995958,"Q2"
"231","1205",13419.6395808971,61795.2391063907,64,107,0.487941246945411,43,22.0185263813473,"Q2"
"232","1206",17464.3981025504,61732.4348696144,79,120,0.0417605107650161,41,39.2878190586343,"Q1"
"233","1207",12231.6396717886,61823.379213906,59,96,0.834059193963185,37,6.13980982336216,"Q4"
"234","1208",17254.6766623155,61703.0180399737,52,118,0.331539877923205,66,44.1183680570684,"Q1"
"235","1209",16376.7061340603,61758.763298855,56,95,0.124636540189385,39,34.139174932614,"Q2"
"236","121",12352.1360678662,61820.405450105,60,105,0.775995661737397,45,10.0801952218171,"Q4"
"237","1210",12463.0526212049,61816.8050372571,59,109,0.716768146725371,50,14.1615926637314,"Q3"
"238","1211",12350.5176184857,61818.8694185139,63,94,0.645573267480358,31,10.9872287081089,"Q3"
"239","1212",12128.8286823306,61825.550216508,50,84,0.919902867171913,34,2.72330251615494,"Q4"
"240","1213",19037.5382006247,61651.6762691575,96,148,0.0624820529483259,52,48.7509332466871,"Q1"
"241","1214",14114.9065173737,61790.594667265,55,88,0.329324078513309,33,22.1323054090608,"Q2"
"242","1215",12745.9936701115,61807.3736374408,57,126,0.670597310643643,69,22.7287855655886,"Q3"
"243","1216",14515.9494759886,61783.0943501267,50,87,0.325403407448903,37,24.9600739243906,"Q2"
"244","1217",17817.9104897939,61714.4810784509,56,109,0.167826819466427,53,44.1051785682794,"Q1"
"245","1218",12764.5515952883,61804.6679935367,61,120,0.600989680970088,59,23.5416088227648,"Q3"
"246","1219",12534.6785555658,61816.6350622262,55,128,0.798721157712862,73,14.6933554869611,"Q3"
"247","122",12447.7459629022,61817.5596890027,76,111,0.682856687577441,35,11.1000159347896,"Q3"
"248","1220",12163.0580886185,61825.8806339177,46,119,0.955990564776585,73,3.21268877130933,"Q4"
"249","1221",12328.615023707,61822.1748677268,73,122,0.857860569376498,49,6.96483210055158,"Q4"
"250","1222",13981.085332337,61781.5715790579,53,106,0.463579105911776,53,28.4303073866758,"Q2"
"251","1223",12163.2163485936,61825.5249809594,54,108,0.940298186149448,54,3.2238979479298,"Q4"
"252","1224",12199.1179027528,61824.1543147663,50,96,0.880661026341841,46,5.48959278827533,"Q4"
"253","1225",18035.9317741194,61713.8547079737,57,109,0.13231152924709,52,45.1198004791513,"Q1"
"254","1226",13193.2451846974,61803.5681518383,47,78,0.419611877994612,31,17.992031782167,"Q3"
"255","1227",12369.248015812,61813.9564967938,49,88,0.559320305939764,39,17.1865080683492,"Q3"
"256","1228",12316.9094216061,61820.2594033311,57,94,0.720604921458289,37,10.3376179060433,"Q4"
"257","1229",13193.5255842503,61802.3568143915,63,97,0.458730851300061,34,18.4031510557979,"Q3"
"258","123",13862.7322139723,61791.468768389,72,105,0.397360164206475,33,19.8871145811863,"Q2"
"259","1230",14354.9300114799,61775.2449784083,58,109,0.442801775177941,51,28.417109465925,"Q2"
"260","1231",14313.9774326938,61767.5229809566,51,118,0.486979486886412,67,34.3723743786104,"Q2"
"261","1232",12349.1670300507,61818.9228827541,61,94,0.659532084362581,33,11.2354412160348,"Q3"
"262","1233",12178.7028061215,61825.0657747966,68,106,0.913698457879946,38,3.27945860056207,"Q4"
"263","1234",12281.7998149305,61821.830471205,54,97,0.796686690300703,43,8.74247231706977,"Q4"
"264","1235",15889.8733225205,61755.7968071684,78,115,0.193774200044572,37,29.8303545983508,"Q2"
"265","1236",13943.2291790469,61784.6963750395,75,117,0.465341246686876,42,22.4556676391512,"Q2"
"266","1237",21280.0690210202,61577.2545259618,69,141,0.0932403686456382,72,65.286693457514,"Q1"
"267","1238",12550.6755192882,61810.5528285375,56,105,0.592849212465808,49,19.9503885891754,"Q3"
"268","1239",12444.9160255965,61817.9197660611,77,113,0.702070939587429,36,10.7254461748526,"Q3"
"269","124",12540.9248105414,61809.4053520894,52,103,0.578612753888592,51,21.4907495516818,"Q3"
"270","1240",12843.7183103774,61804.1942150623,61,132,0.659587157890201,71,24.1693117897958,"Q3"
"271","1241",12572.8923614232,61811.3933781652,56,110,0.638244641711935,54,19.5347893475555,"Q3"
"272","1242",21221.1996354687,61608.3205378934,52,125,0.097607663134113,73,65.8746405912098,"Q1"
"273","1243",12602.1310364629,61810.0555409707,57,111,0.621694466099143,54,20.4284988306463,"Q3"
"274","1244",16715.3829375312,61749.0934082987,58,100,0.134369160979986,42,36.3564952388406,"Q2"
"275","1245",17892.9213179835,61679.7374731282,50,122,0.329861311474815,72,48.2499855738133,"Q1"
"276","1246",19003.8505409667,61642.193432396,57,130,0.267024483531713,73,53.5072127021849,"Q1"
"277","1247",12363.2705841946,61818.0806993003,56,94,0.662404806818813,38,12.8286173408851,"Q3"
"278","1248",12553.7307790825,61813.9914808695,57,115,0.703139470657334,58,17.2179107018746,"Q3"
"279","1249",17952.9941055259,61715.0917890716,63,113,0.119335686787963,50,44.0332156606019,"Q1"
"280","125",16493.3679437496,61759.6020747102,50,89,0.110625875648111,39,34.6855908497237,"Q2"
"281","1250",12848.2462406599,61802.7238765626,56,130,0.64532670006156,74,26.2458241954446,"Q3"
"282","1251",12571.5870872505,61810.4475792654,58,99,0.546603494556621,41,18.5892567231786,"Q3"
"283","1252",12314.4475003662,61821.732214468,54,108,0.833734416868538,54,8.97834148909897,"Q4"
"284","1253",14914.8218505788,61778.8971063674,60,94,0.249145996524021,34,25.5290361181833,"Q2"
"285","1254",12518.5380586687,61813.6172032059,58,107,0.648792548105121,49,17.2091651428491,"Q3"
"286","1255",14415.0717101175,61774.0933577158,92,128,0.402642588829622,36,21.5048668021336,"Q2"
"287","1256",13493.1127499114,61788.0097303583,61,120,0.531646552029997,59,27.6328534302302,"Q2"
"288","1257",15856.0802023308,61759.4498615418,72,109,0.188486549304798,37,30.0259976757225,"Q2"
"289","1258",12230.6838820987,61822.2708827648,49,86,0.777205724036321,37,8.24338821065612,"Q4"
"290","1259",12512.0610067109,61812.1614139025,57,94,0.536543525988236,37,17.1478895384353,"Q3"
"291","126",18436.2523495799,61683.164057833,51,115,0.231508784927428,64,49.1834377646446,"Q1"
"292","1260",12429.9143053881,61819.8801080164,69,128,0.833754384424537,59,9.80849131895229,"Q4"
"293","1261",12986.9633563929,61802.3342450009,66,111,0.538073021220043,45,20.7867140450981,"Q3"
"294","1262",12355.8869594259,61820.9899905182,55,114,0.832651649601758,59,9.87355267349631,"Q4"
"295","1263",15526.2069969319,61758.8505288508,57,103,0.315265850629658,46,31.4977708710358,"Q2"
"296","1264",12342.6290746579,61819.534836899,58,96,0.707865196745843,38,11.101122523658,"Q4"
"297","1265",17844.8719627339,61711.5857463394,77,124,0.102471163263544,47,42.1838553266134,"Q1"
"298","1266",19289.0314416553,61703.4022822198,52,106,0.0229906912427396,54,52.7585026728921,"Q1"
"299","1267",12259.2439183499,61823.1942104569,66,106,0.848681828472763,40,6.05272686108947,"Q4"
"300","1268",16245.0085399758,61740.8952695314,77,120,0.238692395156249,43,32.7362270082813,"Q1"
"301","1269",12578.140222689,61810.0477611879,52,109,0.625829903408885,57,21.3276955056936,"Q3"
"302","127",12449.9204204503,61810.8845634009,46,97,0.591745323501527,51,20.8209885014221,"Q3"
"303","1270",12494.5272974841,61809.3498544764,47,100,0.582231491105631,53,22.1417309714016,"Q3"
"304","1271",20945.3551103159,61622.5813295088,60,128,0.0652560158632696,68,63.5625909212977,"Q1"
"305","1272",12639.2033280972,61812.9484635881,59,128,0.742690064013004,69,17.7543855831027,"Q3"
"306","1273",12296.2539168205,61820.656675806,57,91,0.71287018363364,34,9.76241375645623,"Q4"
"307","1274",12176.7283319079,61825.6904966384,55,122,0.951259079622105,67,3.26564166531898,"Q4"
"308","1275",18607.0631343798,61712.0357462367,58,109,0.0534011914860457,51,48.2765392342117,"Q1"
"309","1276",12327.7487907152,61822.980740222,68,143,0.915692799026147,75,6.32304007303901,"Q4"
"310","1277",12364.0260091628,61819.701977462,57,103,0.756303890841082,46,11.2100210213102,"Q4"
"311","1278",12238.8412322881,61823.4523107644,57,101,0.857800152152777,44,6.25679330527782,"Q4"
"312","1279",12640.9293690162,61808.2922959515,60,108,0.571669054683298,48,20.5598853752017,"Q3"
"313","128",16756.4236577772,61741.22731744,48,96,0.221523736137897,48,37.366860665381,"Q1"
"314","1280",12565.6333967262,61807.6940166096,50,104,0.571569318883121,54,23.1352567803115,"Q3"
"315","1281",12437.3991500363,61818.4135757949,68,113,0.746168536366895,45,11.4224158634897,"Q3"
"316","1282",12406.5839035604,61816.1539496959,64,95,0.571872323518619,31,13.2719579709228,"Q3"
"317","1283",18259.9442203284,61669.3841141134,61,128,0.277725303312764,67,48.3924046780448,"Q1"
"318","1284",16941.1384341685,61734.0947669637,68,113,0.169369529932737,45,37.3783711530268,"Q1"
"319","1285",15204.2993104477,61780.1587168612,47,79,0.18499490711838,32,26.0801629722118,"Q2"
"320","1286",16809.3266887647,61739.5720383453,59,105,0.185970828635618,46,37.4453418827616,"Q1"
"321","1287",12391.9583099982,61817.9952198492,55,100,0.704574593575671,45,13.2941432890948,"Q3"
"322","1288",17679.9224493216,61733.1631612811,57,103,0.0787864211015403,46,42.3758246293291,"Q1"
"323","1289",15947.4986134668,61734.8175256289,62,121,0.388258773367852,59,36.0927323712967,"Q1"
"324","129",12566.1723183238,61814.2310335094,62,118,0.710071643581614,56,16.2359879594296,"Q3"
"325","1290",12410.968241605,61813.7025147128,50,93,0.587916607270017,43,17.7195858873893,"Q3"
"326","1291",12249.9285725012,61823.6073715895,67,110,0.872390204807743,43,5.48722119326703,"Q4"
"327","1292",12155.353160543,61826.0399872713,63,121,0.958645126083866,58,2.39858268713579,"Q4"
"328","1293",13365.8678597086,61795.4436720756,64,109,0.500889108516276,45,22.4599901167676,"Q2"
"329","1294",12619.3703224402,61810.9503653325,72,112,0.586709284223616,40,16.5316286310554,"Q3"
"330","1295",15826.9507618002,61766.4318479593,57,94,0.166972680250183,37,30.8220108307432,"Q2"
"331","1296",12181.0556307858,61824.6900081128,65,96,0.877990593435243,31,3.78229160350747,"Q4"
"332","1297",16945.8729018806,61754.7466697441,52,92,0.0619226447306573,40,37.5230942107737,"Q2"
"333","1298",14933.2914771244,61747.0895353557,57,132,0.49641907424666,75,37.7685694315005,"Q2"
"334","1299",12325.7192991138,61822.1887065575,70,120,0.856703100260347,50,7.16484498698264,"Q4"
"335","13",19979.9900572463,61668.8786356482,59,119,0.0467817410826683,60,57.1930955350399,"Q1"
"336","130",12171.117557271,61824.8343965104,59,93,0.887679500039667,34,3.81889699865133,"Q4"
"337","1300",19650.7543847477,61657.9252367013,57,121,0.129397782962769,64,55.7185418903828,"Q1"
"338","1301",12477.6971326324,61815.0390857158,65,104,0.625039054779336,39,14.6234768636059,"Q3"
"339","1302",12557.4213399292,61809.3598993759,54,104,0.576863325666636,50,21.1568337166682,"Q3"
"340","1303",12348.0323935202,61815.9803555229,51,87,0.580669951392338,36,15.0958817498758,"Q3"
"341","1304",18442.6640315843,61660.1149184752,63,131,0.274913140339777,68,49.3059064568952,"Q1"
"342","1305",15471.517661603,61776.4235817601,46,79,0.170717995846644,33,27.3663061370607,"Q2"
"343","1306",12891.6683481643,61801.8562385499,64,133,0.63712387974374,69,25.0384522976819,"Q3"
"344","1307",18189.9164820069,61707.145124489,45,101,0.191575800999999,56,45.2717551440001,"Q1"
"345","1308",17950.4038927331,61656.9419302359,85,146,0.280690644169226,61,43.8778707056772,"Q1"
"346","1309",15816.6361827045,61742.90467336,60,115,0.367954647401348,55,34.7624943929259,"Q1"
"347","131",15213.4766934537,61755.0566581551,58,114,0.412098037078977,56,32.9225099235773,"Q2"
"348","1310",13320.3838445118,61799.1633923623,52,90,0.442530446685851,38,21.1838430259377,"Q3"
"349","1311",14814.2346063353,61780.507114961,66,98,0.244521846063435,32,24.1753009259701,"Q2"
"350","1312",16946.0458802439,61751.6948968032,73,110,0.0217077287379652,37,36.1968140366953,"Q2"
"351","1313",13580.7872554831,61790.0551669349,75,121,0.516694247722626,46,22.2320646047592,"Q2"
"352","1314",12432.0058451301,61814.6242383235,58,90,0.534388606436551,32,14.8995645940304,"Q3"
"353","1315",12244.4775580651,61822.9533346787,62,95,0.803694759029895,33,6.47807295201346,"Q4"
"354","1316",20195.9174689505,61638.4212665147,52,121,0.137707205722108,69,59.4982028051745,"Q1"
"355","1317",12552.3630065002,61815.1500140056,68,120,0.720484716352075,52,14.5347947496921,"Q3"
"356","1318",13760.1678202691,61792.7621587114,53,91,0.405668827705085,38,22.5845845472068,"Q2"
"357","1319",17160.2332291191,61719.1266509877,52,109,0.270055160857737,57,41.606855831109,"Q1"
"358","132",12335.6566137185,61820.0310611187,55,98,0.74526783823967,43,10.9534829556942,"Q4"
"359","1320",12591.6055958011,61811.6888741706,50,116,0.691099046263844,66,20.3874629465863,"Q3"
"360","1321",12436.3011069911,61814.5553769756,59,96,0.57839489588514,37,15.5993888522498,"Q3"
"361","1322",12089.4367557885,61826.3224652736,59,94,0.986600225092843,35,0.468992121750489,"Q4"
"362","1323",12158.0769860594,61826.006426911,55,120,0.958240657811984,65,2.71435724222101,"Q4"
"363","1324",12197.9976276834,61824.7060969522,64,107,0.90589550184086,43,4.04649342084303,"Q4"
"364","1325",12350.5081023073,61818.9691145919,49,98,0.738252873765305,49,12.8256091855001,"Q4"
"365","1326",18634.9046360607,61689.2514802432,58,116,0.151916583767161,58,49.1888381415047,"Q1"
"366","1327",18355.5091078504,61704.7169349165,54,109,0.138087908737361,55,47.4051650194451,"Q1"
"367","1328",13976.246355838,61787.6052543518,48,90,0.411695213755593,42,24.7088010222651,"Q2"
"368","1329",18355.6629969216,61668.6778857093,54,124,0.286580293439329,70,49.939379459247,"Q1"
"369","133",15230.7636249932,61772.2346287665,46,85,0.290202290518209,39,27.6821106697898,"Q2"
"370","1330",19259.5666507931,61683.9079679954,47,107,0.126403868431225,60,52.4157678941265,"Q1"
"371","1331",13207.5282572617,61799.2814493407,52,94,0.469819577177987,42,22.2675777585246,"Q3"
"372","1332",20349.1905546101,61648.6181575867,68,129,0.0339112197980285,61,58.9314155923203,"Q1"
"373","1333",16875.543281235,61744.0300219251,57,101,0.145769933471456,44,37.5861229272559,"Q1"
"374","1334",12273.327886064,61823.5783733318,61,122,0.901260438840836,61,6.02311323070899,"Q4"
"375","1335",12374.283645856,61819.9666363239,50,111,0.809674930293113,61,11.6098292521201,"Q4"
"376","1336",13482.0421894034,61790.0994074076,60,114,0.514487179694697,54,26.2176922964863,"Q2"
"377","1337",17373.9525438569,61704.8909015971,50,114,0.311166215222329,64,44.085362225771,"Q1"
"378","1338",12527.8789640695,61817.3874325856,63,133,0.815966105321422,70,12.8823726275004,"Q3"
"379","1339",12437.5752239459,61818.7477747402,62,116,0.781325556570664,54,11.8084199451841,"Q3"
"380","134",12112.5119852464,61826.1310525859,49,90,0.956555739510804,41,1.78121468005702,"Q4"
"381","1340",12609.9459859002,61809.3324255406,52,112,0.633374738739803,60,21.9975156756118,"Q3"
"382","1341",12483.1699507933,61814.797437398,56,105,0.664459406398237,49,16.4414890864864,"Q3"
"383","1342",12090.4726592814,61826.3224652736,58,121,0.993790924781933,63,0.391171738738194,"Q4"
"384","1343",15836.7524731578,61748.6619131636,68,114,0.304615075467154,46,31.9877065285109,"Q2"
"385","1344",15206.7460810101,61774.3006803578,68,101,0.206538969883695,33,26.1842139938381,"Q2"
"386","1345",12466.6263030616,61819.2193371767,61,134,0.847365781664848,73,11.1422979384661,"Q4"
"387","1346",12404.1740753455,61813.6130512762,49,82,0.509375652298331,33,16.1906034741551,"Q3"
"388","1347",12101.0991737005,61826.3224652736,60,131,0.990520512219518,71,0.673043632414192,"Q4"
"389","1348",12190.074833393,61825.2758460628,51,118,0.940521333366632,67,3.98507066443563,"Q4"
"390","1349",15888.1893281644,61767.9290705999,56,92,0.138774158200249,36,31.004130304791,"Q2"
"391","135",12196.309445677,61824.7589892409,56,107,0.914146169321612,51,4.37854536459781,"Q4"
"392","1350",16914.3446565379,61730.8748808585,56,107,0.233763052849099,51,39.0780843046959,"Q1"
"393","1351",12495.8807655228,61814.3425876935,55,106,0.665620994288474,51,17.0533292912878,"Q3"
"394","1352",13974.1042668768,61784.216546968,69,113,0.460355490446091,44,23.744358420372,"Q2"
"395","1353",16407.9845411847,61733.4837865438,65,116,0.294605196686462,51,35.9751349689905,"Q1"
"396","1354",14779.8697109945,61751.934544158,61,133,0.504014638718218,72,35.7109460122883,"Q2"
"397","1355",12522.8881465901,61815.8052953908,69,117,0.712921540252864,48,13.7797660678625,"Q3"
"398","1356",17921.8750039226,61682.5965414187,60,125,0.285406739218161,65,46.4485619508196,"Q1"
"399","1357",16291.9058374469,61753.1104983029,48,92,0.221364737488329,44,34.2599515505135,"Q2"
"400","1358",15049.4975949444,61755.3060795927,58,118,0.441468742676079,60,33.5118754394352,"Q2"
"401","1359",12334.4981988459,61819.4316328818,44,101,0.780174101237208,57,12.5300762294792,"Q4"
"402","136",15276.2051453751,61757.6882203091,66,114,0.371473590377718,48,30.1692676618695,"Q2"
"403","1360",17293.4055645848,61694.4921295194,68,130,0.321144871879369,62,42.0890179434791,"Q1"
"404","1361",12581.7519741027,61812.6441102907,57,115,0.682401481783018,58,18.420714056585,"Q3"
"405","1362",19339.0576347181,61641.4682668476,56,127,0.225714329630136,71,54.9742825962603,"Q1"
"406","1363",12229.5030383407,61822.9529660378,54,90,0.804997911443934,36,7.02007518801838,"Q4"
"407","1364",17840.688173057,61686.6973920953,47,117,0.328096170444041,70,47.0332680689171,"Q1"
"408","1365",14344.4090353881,61768.4764166715,61,123,0.494176965905353,62,31.3610281138681,"Q2"
"409","1366",21258.3651549954,61615.6421759659,42,114,0.122185577638447,72,63.2026384100318,"Q1"
"410","1367",16517.2194770554,61732.7948573865,56,110,0.298829603008926,54,37.863201437518,"Q1"
"411","1368",12133.8466627714,61825.166567967,46,80,0.898342081578448,34,3.45636922633275,"Q4"
"412","1369",12168.4423412399,61825.6804525692,64,118,0.947827098425478,54,2.8173366850242,"Q4"
"413","137",17689.6233056814,61723.0502738797,63,111,0.118849142687395,48,42.295241151005,"Q1"
"414","1370",12511.6573574271,61815.7215072699,55,115,0.735860698390752,60,15.8483580965549,"Q3"
"415","1371",12245.1099273425,61823.2727438638,56,101,0.853502417681739,45,6.59239120432176,"Q4"
"416","1372",12446.2297049017,61819.7847065306,76,138,0.852729394799098,62,9.1307775224559,"Q4"
"417","1373",16809.2663351876,61729.2710583323,61,112,0.250494815874845,51,38.2247643903829,"Q1"
"418","1374",17949.8677587694,61711.385357807,40,95,0.246871436247602,55,41.4220710063819,"Q1"
"419","1375",16141.875134868,61771.6723942855,59,92,0.0342871132306755,33,31.8685252633877,"Q2"
"420","1376",12101.5864750148,61826.3224652736,65,97,0.972205443540588,32,0.889425806701183,"Q4"
"421","1377",12258.0778761811,61822.6351731297,45,103,0.859479546546936,58,8.15018630027771,"Q4"
"422","1378",14989.5049450759,61763.5455895096,47,101,0.40893438574858,54,31.9175431695767,"Q2"
"423","1379",12702.1793266106,61809.8561842041,62,126,0.68924672040157,64,19.8882098942995,"Q3"
"424","138",12305.6175496685,61823.058005374,56,128,0.902260878356174,72,7.0372167583555,"Q4"
"425","1380",12302.438181214,61821.5542068024,61,100,0.782101294724271,39,8.49804950575344,"Q4"
"426","1381",12244.2331817909,61822.717045752,48,96,0.836373663041741,48,7.85406417399645,"Q4"
"427","1382",12513.8949200613,61813.0221794478,65,102,0.57003386458382,37,15.9087470103987,"Q3"
"428","1383",12470.9442830534,61816.834236654,59,111,0.72770676552318,52,14.1592481927946,"Q3"
"429","1384",12565.060573342,61816.7815192419,70,144,0.833726024022326,74,12.3042742223479,"Q3"
"430","1385",16497.2385190854,61728.6407329546,59,115,0.321424497524276,56,38.0002281386405,"Q1"
"431","1386",16177.1017902045,61739.2922081714,50,106,0.3383482277859,56,37.0524992439896,"Q1"
"432","1387",12361.1028393282,61819.063917003,57,98,0.711806325707585,41,11.815940645989,"Q4"
"433","1388",12823.2304741067,61802.7819017955,52,128,0.644017711747438,76,27.0546539071947,"Q3"
"434","1389",15073.2151433801,61768.449996677,75,112,0.299428678350523,37,25.9211389010306,"Q2"
"435","139",12427.0668383756,61818.5483454915,64,111,0.749939667526633,47,11.7528356262483,"Q3"
"436","1390",16311.0628596068,61760.3017923303,53,92,0.132293765433133,39,33.8405431481078,"Q2"
"437","1391",12229.4541852636,61823.3176119662,59,94,0.823191790375859,35,6.18828733684495,"Q4"
"438","1392",12402.3509093085,61814.0841720937,42,99,0.679210944566876,57,18.2849761596881,"Q3"
"439","1393",12213.3000059134,61823.4645235841,51,91,0.838327766163275,40,6.46688935346901,"Q4"
"440","1394",15944.7400316976,61734.9144588965,58,119,0.392661613179371,61,37.0476415960584,"Q1"
"441","1395",12339.9000076519,61820.7780692935,54,106,0.803278015460819,52,10.2295431960374,"Q4"
"442","1396",16647.0049026199,61723.8570164462,45,108,0.369355926290154,63,39.7305766437203,"Q1"
"443","1397",12468.976692701,61816.5245680557,58,109,0.714048539521173,51,14.5835244844202,"Q3"
"444","1398",12209.777226355,61822.9420753976,47,86,0.811851072357967,39,7.33780817803927,"Q4"
"445","1399",18203.3275502298,61681.1106523589,62,124,0.239324708934873,62,47.1618680460379,"Q1"
"446","14",21896.229893063,61603.9925973531,55,127,0.0293347390834242,72,69.8878987859935,"Q1"
"447","140",12401.9774460865,61820.5284698289,69,126,0.8398489409592,57,9.12861036532559,"Q4"
"448","1400",12661.9075879514,61812.1058457563,66,128,0.719319539144635,62,17.4021885730326,"Q3"
"449","1401",15647.5505352436,61756.7488098099,46,95,0.342322758864611,49,32.226184815634,"Q2"
"450","1402",12467.2602585731,61814.9890681269,63,102,0.617724829586223,39,14.9087316461373,"Q3"
"451","1403",12516.9116945826,61811.3663470852,52,103,0.608058747602627,51,19.989003872266,"Q3"
"452","1404",12979.3071442749,61803.2555926499,64,106,0.521699114702642,42,20.088637182489,"Q3"
"453","1405",15392.7616609438,61764.7872945178,40,85,0.394007122376934,45,27.269679493038,"Q2"
"454","1406",13755.4229906312,61792.9029641547,51,89,0.403971150750294,38,22.6490962714888,"Q2"
"455","1407",12113.4171618828,61826.3224652736,71,109,0.970429216744378,38,1.12368976371363,"Q4"
"456","1408",15608.4297641889,61747.2554402324,66,118,0.374117193976417,52,32.5459059132263,"Q2"
"457","1409",12939.7560219547,61801.3896220873,65,118,0.566519395448267,53,22.9744720412418,"Q3"
"458","141",18087.6735451497,61682.3307232323,39,111,0.381952906493098,72,44.499390732497,"Q1"
"459","1410",17303.995588671,61738.8009883447,56,101,0.107877794653177,45,40.145499240607,"Q1"
"460","1411",12176.999965861,61825.0404041337,48,104,0.924867525696754,56,4.20741856098175,"Q4"
"461","1412",14879.7039392675,61781.7613387234,54,87,0.230573052540421,33,25.3910892661661,"Q2"
"462","1413",21641.807086808,61602.9580308646,53,126,0.0627867693547159,73,68.4165658371057,"Q1"
"463","1414",16775.1167671669,61704.8537561483,77,135,0.344320846488699,58,38.0293909036554,"Q1"
"464","1415",16662.212661467,61708.8561954445,52,124,0.398059410974383,72,43.3397224098444,"Q1"
"465","1416",13051.4534375286,61801.941016959,48,88,0.467964723939076,40,21.281411042437,"Q3"
"466","1417",16700.1265666639,61737.5453940836,89,127,0.107396733481437,38,33.9189241277054,"Q1"
"467","1418",14448.9299885445,61776.4563394759,45,94,0.428822559770197,49,27.9876945712604,"Q2"
"468","1419",12522.9751942921,61815.2705396025,61,114,0.709246743004769,53,15.4099226207472,"Q3"
"469","142",14677.3642123086,61778.2097308184,53,93,0.335750814992934,40,26.5699674002826,"Q2"
"470","1420",12515.9340999442,61815.899960265,60,116,0.732591322390363,56,14.9748859461397,"Q3"
"471","1421",12473.412709615,61814.965860968,65,103,0.615161795867607,38,14.6238517570309,"Q3"
"472","1422",18246.1081183479,61712.7510059381,56,108,0.1085224756971,52,46.3568312637508,"Q1"
"473","1423",15696.566879585,61729.6388260054,64,133,0.456659032963216,69,37.4905267255381,"Q1"
"474","1424",12504.9212791021,61811.9206485143,58,100,0.569043945288286,42,18.100154297892,"Q3"
"475","1425",19407.9135817121,61678.5684209586,54,114,0.1000884140376,60,53.994695157744,"Q1"
"476","1426",16265.2889394038,61758.5489804904,54,94,0.155909738969058,40,33.7636104412377,"Q2"
"477","1427",12701.8205625792,61803.0135835843,49,109,0.560741915134713,60,26.3554850919172,"Q3"
"478","1428",15698.619366764,61748.3138221877,71,118,0.333730492508039,47,31.3146668521222,"Q2"
"479","1429",14617.4852818555,61778.7024633664,65,102,0.333781174384058,37,24.6500965477899,"Q2"
"480","143",12188.6330932416,61825.9728498337,67,140,0.960188714321703,73,2.9062238545157,"Q4"
"481","1430",15786.7630249526,61732.9534184878,73,131,0.414161331020296,58,33.9786428008229,"Q1"
"482","1431",12084.8256791363,61826.3224652736,62,115,0.996119671501219,53,0.205657410435379,"Q4"
"483","1432",17864.1437475789,61736.327165812,65,108,0.00588119099847972,43,42.7471087870654,"Q1"
"484","1433",17071.9359715529,61728.9722759332,64,112,0.191307336091995,48,38.8172478675842,"Q1"
"485","1434",18722.607701881,61696.3933753753,56,112,0.115268641617149,56,49.5449560694396,"Q1"
"486","1435",12875.2377229403,61800.2995350382,57,122,0.587414193432778,65,26.8180774268694,"Q3"
"487","1436",12615.0724338141,61809.1808203758,57,111,0.609540287172422,54,21.0848244926892,"Q3"
"488","1437",14176.6905402073,61782.7484850117,60,103,0.416251427028328,43,25.1011886377819,"Q2"
"489","1438",12084.8909616277,61826.3224652736,57,133,0.997542749159038,76,0.186751063913107,"Q4"
"490","1439",17246.9476617495,61716.990207184,63,116,0.233282251050696,53,40.6360406943131,"Q1"
"491","144",13469.6369983468,61795.6569574522,55,96,0.451386119006202,41,22.4931691207457,"Q2"
"492","1440",14704.5793154827,61769.2040928292,56,107,0.41504609468393,51,29.8326491711196,"Q2"
"493","1441",12423.8369050729,61817.145142242,60,102,0.67869111825712,42,13.4949730332009,"Q3"
"494","1442",17170.9958390517,61717.0910210583,79,126,0.187416737200692,47,38.1914133515675,"Q1"
"495","1443",12229.4280520499,61823.7469180875,67,102,0.852552998811007,35,5.16064504161477,"Q4"
"496","1444",13514.7397322092,61786.7059477318,38,101,0.548289512982592,63,28.4577606820967,"Q2"
"497","1445",17964.7791321088,61728.3825060895,70,114,0.0204761857166886,44,43.0990478284657,"Q1"
"498","1446",12423.6832446825,61819.7174479641,57,123,0.83067010040395,66,11.1757733733393,"Q4"
"499","1447",15863.2085012278,61757.4973284164,63,104,0.233516183216125,41,31.4258364881389,"Q2"
"500","1448",16299.5368987938,61750.9368720763,59,102,0.202931863022968,43,34.2739298900124,"Q2"
"501","1449",19547.7395583521,61657.3580904277,61,124,0.13061179802753,63,54.7714567242656,"Q1"
"502","145",12552.3992784658,61814.4646704083,51,119,0.741136795841157,68,17.6026978828013,"Q3"
"503","1450",12339.2534396858,61817.94735591,48,92,0.684986977372319,44,13.860572995618,"Q3"
"504","1451",13023.9763356841,61802.5508349882,79,120,0.555609268369153,41,18.2200199968647,"Q3"
"505","1452",16093.9214557835,61774.9218474261,57,89,0.0129508855752647,32,31.5855716615915,"Q2"
"506","1453",17147.1062502473,61746.691463354,47,90,0.108117398805916,43,38.3509518513456,"Q2"
"507","1454",18112.6126675711,61732.5430433842,41,86,0.0725026167929173,45,41.7373822443187,"Q1"
"508","1455",12289.8239343793,61822.1676931075,68,103,0.795893111033365,35,7.14374111383222,"Q4"
"509","1456",12082.4020490566,61826.3224652736,54,86,0.993870324920863,32,0.196149602532387,"Q4"
"510","1457",12302.5878657224,61820.4469885758,60,91,0.689527718583122,31,9.62464072392322,"Q4"
"511","1458",12338.3774381818,61820.4926389251,51,104,0.795284447725862,53,10.8499242705293,"Q4"
"512","1459",12209.5887183552,61824.0917726081,54,99,0.879347087815404,45,5.42938104830682,"Q4"
"513","146",12138.7370354455,61825.7416568204,63,99,0.937664434779435,36,2.24408034794033,"Q4"
"514","1460",22006.807747902,61595.1583540502,45,120,0.0757577940821648,75,69.3181654438376,"Q1"
"515","1461",12684.5581996724,61808.9020468783,50,123,0.688095320714638,73,22.7690415878315,"Q3"
"516","1462",12917.9840607083,61806.5892630013,63,97,0.489073075121269,34,17.3715154458769,"Q3"
"517","1463",14634.5572022346,61772.2912296947,60,107,0.404835365014151,47,27.9727378443349,"Q2"
"518","1464",18248.2629744412,61692.9971762677,57,116,0.198675153078511,59,47.2781659683678,"Q1"
"519","1465",16284.6151084546,61768.9483950656,59,93,0.0346952052786946,34,32.8203630205244,"Q2"
"520","1466",12554.7795260495,61812.0488510673,63,108,0.609654627274722,45,17.5655417726375,"Q3"
"521","1467",12580.1025547076,61810.7179828046,54,110,0.634688710095361,56,20.4574322346598,"Q3"
"522","1468",12238.0530656442,61824.062155729,82,120,0.890673596877605,38,4.15440331865102,"Q4"
"523","1469",12236.3917125206,61824.9345300189,63,138,0.942597806220874,75,4.30516453343444,"Q4"
"524","147",13452.0093668418,61793.4351588311,57,104,0.483975074021146,47,24.2531715210062,"Q2"
"525","1470",19261.2432360429,61629.6036280183,61,134,0.253289672778919,73,54.5098538871389,"Q1"
"526","1471",12374.121780869,61815.3669577934,55,88,0.546294896863401,33,14.9722684035078,"Q3"
"527","1472",12854.7968978134,61805.4554777022,63,138,0.696524279657751,75,22.7606790256687,"Q3"
"528","1473",12925.8180083182,61799.4755230341,58,133,0.62881765794009,75,27.8386756544933,"Q3"
"529","1474",12412.7455364265,61818.6252863192,52,110,0.774700236273929,58,13.0673862961121,"Q3"
"530","1475",12116.2337009325,61825.9097094831,52,85,0.940354189369828,33,1.96831175079569,"Q4"
"531","1476",12281.7340734815,61818.7659626109,50,82,0.619761958951131,32,12.1676173135638,"Q3"
"532","1477",17312.2466407654,61738.2766269863,52,98,0.122450393857434,46,40.367281882558,"Q1"
"533","1478",14848.8007437169,61780.6332789184,50,85,0.2660512260627,35,25.6882070878055,"Q2"
"534","1479",14963.8030455615,61771.4813394269,60,101,0.327334196539596,41,27.5792979418766,"Q2"
"535","148",16286.6756944695,61728.394658427,66,122,0.35001257318072,56,36.3992959018797,"Q1"
"536","1480",12641.6376519835,61814.0268151015,65,137,0.782238168176264,72,15.678851891309,"Q3"
"537","1481",17645.8966068025,61690.0031677803,57,123,0.309418278047815,66,45.5783936488442,"Q1"
"538","1482",19010.1706973265,61667.1423569755,57,121,0.185570606496185,64,52.1234811842442,"Q1"
"539","1483",12409.429735165,61818.6540316177,66,107,0.723996774526313,41,11.3161322444212,"Q3"
"540","1484",12244.9348542275,61823.9409488662,70,116,0.892613283125684,46,4.93978897621855,"Q4"
"541","1485",17564.3136544169,61719.9761305668,59,110,0.171239707153291,51,42.2667749351822,"Q1"
"542","1486",14417.4061523354,61776.7788159524,63,108,0.415974681265652,45,26.2811393430457,"Q2"
"543","1487",12085.9329554459,61826.3224652736,54,107,0.994540460873395,53,0.289355573710054,"Q4"
"544","1488",12645.5249716644,61805.0148923995,49,111,0.586044733179733,62,25.6652265428565,"Q3"
"545","1489",18481.9375481138,61714.8397266362,48,100,0.0904125988017768,52,47.2985448623076,"Q1"
"546","149",14875.9426956512,61781.768782474,59,91,0.221500105923042,32,24.9119966104627,"Q2"
"547","1490",12383.226111056,61818.1615808668,60,98,0.67532080761157,38,12.3378093107603,"Q3"
"548","1491",17027.2046473939,61715.4806128477,65,120,0.27743001980707,55,39.7413489106111,"Q1"
"549","1492",12229.0891542099,61822.7480665403,56,87,0.77215884369798,31,7.06307584536262,"Q4"
"550","1493",12278.0422749097,61817.4538121138,43,84,0.659082283498719,41,13.9776263765525,"Q3"
"551","1494",16310.521502138,61768.3018737433,54,89,0.0494223656132817,35,33.2702172035351,"Q2"
"552","1495",12258.0532962972,61821.5260223148,49,89,0.765831415308639,40,9.36674338765442,"Q4"
"553","1496",14940.9765934466,61765.3774766012,54,105,0.39511577761732,51,30.8490953415167,"Q2"
"554","1497",12090.6401579205,61826.3224652736,66,103,0.988353080116212,37,0.430936035700142,"Q4"
"555","1498",12582.0516412883,61810.3319846088,61,104,0.565657588886097,43,18.6767236778978,"Q3"
"556","1499",12187.1295123307,61824.3764989965,57,92,0.866758841089904,35,4.66344056185335,"Q4"
"557","15",12372.884148463,61816.2392737081,47,94,0.663672926370054,47,15.8073724606074,"Q3"
"558","150",12129.076958715,61826.1474881551,60,106,0.959418796468526,46,1.8667353624478,"Q4"
"559","1500",18450.1059946939,61682.9445449958,61,121,0.195946745341644,60,48.2431952795014,"Q1"
"560","1501",17587.7063238445,61745.3440316299,44,86,0.0541194872930646,42,39.7269815336913,"Q1"
"561","1502",21718.4636573582,61572.1909170397,57,134,0.102664601057768,77,69.0948257185519,"Q1"
"562","1503",14887.172777526,61765.0448972571,59,110,0.408316342625767,51,30.1758665260859,"Q2"
"563","1504",12407.0301629172,61818.1020717112,61,103,0.70386190363206,42,12.4378000474535,"Q3"
"564","1505",12086.9016309267,61826.3224652736,51,124,0.996098926058039,73,0.284778397763148,"Q4"
"565","1506",15540.0253673616,61763.0896573332,48,92,0.298627451993525,44,30.8603921122849,"Q2"
"566","1507",16845.016346544,61725.9866146204,72,120,0.228398969396949,48,37.0368494689465,"Q1"
"567","1508",12251.7678952622,61822.9192146816,51,100,0.848132685991004,49,7.4414983864408,"Q4"
"568","1509",12347.1408733392,61820.8691556109,64,108,0.791856552008539,44,9.15831171162426,"Q4"
"569","151",14782.7769053952,61779.0685045014,58,94,0.288875608704984,36,25.6004780866206,"Q2"
"570","1510",12506.1546515142,61816.8559969552,61,120,0.764624493662268,59,13.8871548739262,"Q3"
"571","1511",13165.3606562909,61802.6568762778,66,100,0.469851405592635,34,18.0250522098504,"Q3"
"572","1512",13825.6115216794,61788.3116839016,50,95,0.435507852816954,45,25.4021466232371,"Q2"
"573","1513",12901.8054652354,61804.6543980379,85,154,0.730525098042563,69,18.5937682350632,"Q3"
"574","1514",12267.3941544296,61823.2501553778,47,115,0.893486218061298,68,7.24293717183173,"Q4"
"575","1515",14554.2892253023,61776.3066245434,54,99,0.38649060507305,45,27.6079227717128,"Q2"
"576","1516",12295.0851442563,61822.9825344369,48,123,0.898644065484405,75,7.60169508866966,"Q4"
"577","1517",12726.5151184935,61806.9336136648,53,95,0.513118613744155,42,20.4490182227455,"Q3"
"578","1518",18054.6727678709,61677.7289933723,56,124,0.294283530674875,68,47.9887199141085,"Q1"
"579","1519",15971.1583443408,61767.6826443293,60,95,0.11171732400544,35,31.0898936598096,"Q2"
"580","152",12219.1245401361,61823.9409029488,54,101,0.878745600581169,47,5.69895677268505,"Q4"
"581","1520",14242.8795378232,61783.9654204173,73,108,0.373874819837511,35,21.9143813056871,"Q2"
"582","1521",12355.776636728,61819.028876263,62,96,0.673947625793517,34,11.0857807230204,"Q4"
"583","1522",13448.3311730903,61793.6533558307,73,117,0.513530948664993,44,21.4046382587403,"Q2"
"584","1523",13007.1715008027,61796.7531713241,60,131,0.602276811143383,71,28.2383464088198,"Q2"
"585","1524",13511.3209477346,61797.0638085851,68,102,0.437032905872911,34,19.140881200321,"Q2"
"586","1525",14124.3645928387,61786.6822080403,55,94,0.38260564673692,39,24.0783797772601,"Q2"
"587","1526",12251.5117978537,61822.7084990438,51,97,0.832176359836012,46,7.71988744754344,"Q4"
"588","1527",12880.3161523669,61800.8084443046,60,126,0.603383402340114,66,26.1766954455525,"Q3"
"589","1528",12275.3049392504,61821.0196148422,55,88,0.713931681588292,33,9.44025450758636,"Q4"
"590","1529",17323.4601653439,61710.5723193214,47,109,0.30851481272839,62,42.8720816108398,"Q1"
"591","153",15019.2522436256,61748.3177051158,86,140,0.471605430589989,54,28.5333067481406,"Q2"
"592","1530",18809.3267183059,61658.85354344,46,119,0.29077957989648,73,51.773090667557,"Q1"
"593","1531",13710.4925958972,61784.1571743591,52,110,0.492703641531989,58,29.4231887911446,"Q2"
"594","1532",16389.0435043252,61761.4458433772,64,100,0.0736727202311158,36,33.3477820716798,"Q2"
"595","1533",12193.9583603399,61824.5239545837,53,100,0.89799260860309,47,4.79434739565477,"Q4"
"596","1534",12274.1393091446,61823.4291834397,76,122,0.884935951326042,46,5.29294623900205,"Q4"
"597","1535",15978.7089417418,61727.0781897674,63,128,0.421145762084052,65,37.6255254645366,"Q1"
"598","1536",17596.5570650515,61725.6670735784,25,74,0.2760483562015,49,35.4736305461265,"Q1"
"599","1537",12234.0069417593,61823.3221546417,63,96,0.820768561447039,33,5.9146374722477,"Q4"
"600","1538",18793.0766018049,61642.9784188635,55,131,0.300612618681043,76,53.1534409802407,"Q1"
"601","1539",12171.3000411772,61823.0769100818,43,77,0.80078021530062,34,6.77347267977893,"Q4"
"602","154",12501.5707060432,61817.6776190688,54,128,0.815126727335155,74,13.6806221771985,"Q3"
"603","1540",12305.6809731487,61820.2984019325,54,92,0.721703631337732,38,10.5752620091662,"Q4"
"604","1541",14983.0534328023,61760.0669568772,54,111,0.423813213827088,57,32.842646811856,"Q2"
"605","1542",12763.7569975603,61807.3118275461,56,129,0.685935515677556,73,22.9267073555384,"Q3"
"606","1543",18204.0942666729,61699.6042470121,56,113,0.179132671328261,57,46.7894377342891,"Q1"
"607","1544",15940.9138021592,61752.0910505478,66,109,0.255921027855948,43,31.9953958021943,"Q2"
"608","1545",12179.5183930434,61824.7594197154,53,97,0.90130066475831,44,4.34277075063437,"Q4"
"609","1546",18953.066522247,61687.7255777937,56,114,0.119094138266519,58,51.0925399805419,"Q1"
"610","1547",15058.1614848561,61778.8096608938,54,88,0.22139726113528,34,26.4724931214005,"Q2"
"611","1548",14631.9616429091,61765.403721371,68,122,0.4616489270702,54,29.0709579382092,"Q2"
"612","1549",12439.3417588582,61814.4265525142,60,96,0.569514978211373,36,15.4974607843906,"Q3"
"613","155",12086.6818465122,61826.3224652736,56,90,0.988678094698116,34,0.38494478026405,"Q4"
"614","1550",16093.3748698816,61755.445841998,58,100,0.211836502421647,42,33.1028668982908,"Q2"
"615","1551",14066.4860991551,61785.0558073042,64,105,0.421882757451385,41,23.7028069444932,"Q2"
"616","1552",21493.6372803841,61568.9741604529,62,138,0.113642798503861,76,67.3631473137066,"Q1"
"617","1553",20812.0809400614,61619.8890148191,62,130,0.0789926655124873,68,62.6284987451509,"Q1"
"618","1554",12836.1442447928,61804.4241487586,57,103,0.528453387785703,46,21.6911441618577,"Q3"
"619","1555",15649.0872218493,61736.7120314018,56,123,0.434658293612301,67,37.8778943279758,"Q1"
"620","1556",12465.5328826021,61818.8317307176,56,128,0.830613495549187,72,12.1958283204585,"Q3"
"621","1557",14929.8022614482,61770.4401927257,73,111,0.325202005216852,38,25.6423238017596,"Q2"
"622","1558",12339.2339397451,61821.8117465861,68,119,0.847780935000628,51,7.76317231496796,"Q4"
"623","1559",12099.8124069446,61826.3224652736,45,91,0.973633025074378,46,1.21288084657863,"Q4"
"624","156",12404.7278675693,61817.1177539382,60,98,0.648900135187432,38,13.3417948628776,"Q3"
"625","1560",12252.2021449456,61822.5523081665,60,93,0.783570185303688,33,7.14218388497829,"Q4"
"626","1561",12674.993787177,61808.4850226177,57,118,0.642082818550989,61,21.8329480683897,"Q3"
"627","1562",12351.2584077699,61819.7180264041,62,99,0.716508358251303,37,10.4891907447018,"Q4"
"628","1563",12176.3249104106,61823.9316365327,50,81,0.821839438984171,31,5.52297739149071,"Q4"
"629","1564",12496.0940176698,61813.3217143028,50,105,0.659493821905926,55,18.7278397951741,"Q3"
"630","1565",13546.3564554522,61797.5295603711,57,91,0.405985905090347,34,20.1964792269282,"Q3"
"631","1566",15679.1421995916,61747.8484294032,55,110,0.369419843191281,55,34.6819086244795,"Q2"
"632","1567",12085.6339413443,61826.3224652736,44,77,0.983618136961013,33,0.540601480286568,"Q4"
"633","1568",12139.2291363538,61826.3224652736,53,127,0.972785237943754,74,2.01389239216223,"Q4"
"634","1569",22033.4164938896,61571.4487131807,61,136,0.0585376699455082,75,70.6096747540869,"Q1"
"635","157",12283.0362582118,61821.8490537372,49,100,0.821130647091195,51,9.12233699834906,"Q4"
"636","1570",13866.1354073126,61782.1939327723,52,108,0.47829580353573,56,29.2154350019991,"Q2"
"637","1571",15864.1646271259,61774.5494918676,52,85,0.0781889969948679,33,30.4197630991694,"Q2"
"638","1572",15175.5269409607,61769.6238113674,59,99,0.292560940608382,40,28.2975623756647,"Q2"
"639","1573",16244.7450949307,61731.8227978274,58,116,0.353802398545668,58,37.4794608843513,"Q1"
"640","1574",12577.0192054132,61812.2821938353,59,91,0.510624210117385,32,15.6600252762437,"Q3"
"641","1575",16868.6403184273,61715.3412156752,79,129,0.260512696579099,50,36.9743651710451,"Q1"
"642","1576",18936.6412141803,61711.3278860252,45,97,0.0565480764489621,52,49.059500024654,"Q1"
"643","1577",12091.0389148572,61826.3224652736,56,100,0.988126546377316,44,0.522431959398091,"Q4"
"644","1578",12620.7445829383,61808.4587406932,58,106,0.567295293556526,48,20.7698259092867,"Q3"
"645","1579",14690.8146362259,61784.5763317963,23,56,0.490748182404786,33,16.8053099806421,"Q2"
"646","158",15582.888679966,61739.1372643835,64,126,0.432023040251806,62,35.214571504388,"Q1"
"647","1580",20545.5676116576,61620.8965135327,68,134,0.0838408598210663,66,60.4665032518096,"Q1"
"648","1581",12305.5744128063,61819.6052555318,50,90,0.706516807200387,40,11.7393277119845,"Q4"
"649","1582",12474.3614497442,61817.1867341576,55,115,0.761240590829402,60,14.3255645502359,"Q3"
"650","1583",12240.452026682,61822.4519654585,49,91,0.80682694981806,42,8.11326810764149,"Q4"
"651","1584",12087.1355902836,61826.3224652736,61,116,0.994836793048307,55,0.283976382343099,"Q4"
"652","1585",18681.2219054436,61711.636080674,70,118,0.00502515537664294,48,47.7587925419211,"Q1"
"653","1586",17088.4728125561,61719.1209775494,39,100,0.381931961048394,61,37.7021503760479,"Q1"
"654","1587",15137.2763246959,61764.2553844135,60,106,0.355728276073933,46,29.6364993005991,"Q2"
"655","1588",13990.1796470645,61788.3880505682,65,102,0.40190389752388,37,22.1295557916164,"Q2"
"656","1589",14244.2334794356,61778.8748432293,65,111,0.440574500244111,46,25.7335729887709,"Q2"
"657","159",12912.9210238899,61802.7803358124,37,85,0.583462376380339,48,19.9938059337437,"Q3"
"658","1590",12200.7264176194,61825.1198854479,55,120,0.936961165862158,65,4.09752421895973,"Q4"
"659","1591",16433.9474880893,61751.0113858265,51,95,0.196986083639786,44,35.3326123198494,"Q2"
"660","1592",16971.4319464378,61708.0433479312,54,120,0.351026499876752,66,42.8322510081343,"Q1"
"661","1593",16766.4324567208,61734.7441212697,70,115,0.193488673772663,45,36.2930096802302,"Q1"
"662","1594",12683.1670683506,61809.4740174196,57,122,0.675309270154685,65,21.1048974399455,"Q3"
"663","1595",13640.3194566424,61795.8335821938,61,95,0.405335542513058,34,20.218591554556,"Q2"
"664","1596",16853.3843448944,61746.9011638595,60,102,0.118952888296917,42,37.0039786915295,"Q2"
"665","1597",12758.9204330858,61808.2420417745,73,131,0.671209526248276,58,19.0698474776,"Q3"
"666","1598",12289.2181260036,61822.3963904478,48,110,0.863860047189519,62,8.44067707424983,"Q4"
"667","1599",19266.1744379431,61697.1777104538,48,104,0.0661452068015933,56,52.2958684191108,"Q1"
"668","16",12104.083767834,61826.3224652736,61,114,0.983533519087359,53,0.872723488369957,"Q4"
"669","160",18922.7550925824,61654.6855316463,57,126,0.240349373780191,69,52.4158932091668,"Q1"
"670","1600",21942.8978433306,61570.8231844114,59,135,0.0756221495103091,76,70.2527166372165,"Q1"
"671","1601",15114.386717543,61779.4342344721,54,87,0.196996427606791,33,26.4991178889759,"Q2"
"672","1602",17507.9770322528,61690.1197580813,62,127,0.318916611140594,65,44.2704202758614,"Q1"
"673","1603",16752.11193339,61722.4367817684,65,119,0.292217811569571,54,38.2202381752431,"Q1"
"674","1604",12138.8747299672,61825.6743287364,48,96,0.94003332243301,48,2.87840052321553,"Q4"
"675","1605",15987.6960119605,61738.9606316609,63,117,0.35317945596762,54,34.9283093777485,"Q1"
"676","1606",13016.4372196459,61804.4442525557,61,97,0.483040364924818,36,18.6105468627065,"Q3"
"677","1607",15734.663145542,61741.5138186976,66,121,0.385456372750923,55,33.7998994986992,"Q1"
"678","1608",12854.3216888722,61801.570233447,57,115,0.565321583999321,58,25.2113481280394,"Q3"
"679","1609",12476.1727612138,61815.3440196126,60,105,0.660478942329064,45,15.2784475951921,"Q3"
"680","161",14916.6464114004,61744.5017078946,66,141,0.518159536411986,75,36.1380347691011,"Q1"
"681","1610",12320.104492879,61819.5857169483,53,92,0.704538111109287,39,11.5230136667378,"Q4"
"682","1611",16049.7379458844,61732.122832273,50,115,0.396911741932854,65,39.2007367743645,"Q1"
"683","1612",12170.161651376,61825.4066650195,53,109,0.937689303187653,56,3.48939902149141,"Q4"
"684","1613",14791.5018547451,61759.1413830253,59,121,0.465989101212472,62,33.1086757248268,"Q2"
"685","1614",12633.7051297235,61813.84699475,59,133,0.773165675578639,74,16.7857400071807,"Q3"
"686","1615",12275.2733796226,61821.9783399516,50,98,0.815495999995619,48,8.85619200021029,"Q4"
"687","1616",17326.007761979,61691.9421411256,56,126,0.355356542859226,70,45.1250419998541,"Q1"
"688","1617",12283.4750459808,61823.7587959602,57,133,0.920246968977153,76,6.06123035773635,"Q4"
"689","1618",12419.6984630771,61820.6242488926,69,139,0.873706685844809,70,8.84053199086338,"Q4"
"690","1619",12122.0572531808,61826.3224652736,45,111,0.971703416202217,66,1.86757453065366,"Q4"
"691","162",12586.8144353637,61807.0575593248,49,107,0.585765220923349,58,24.0256171864457,"Q3"
"692","1620",15915.9830599952,61757.7436862794,74,111,0.183283949969336,37,30.2184938511346,"Q2"
"693","1621",12799.7229056291,61805.4658153135,49,90,0.492007004097104,41,20.8277128320187,"Q3"
"694","1622",12739.8595064715,61803.3786156462,45,92,0.505189803894609,47,23.2560792169534,"Q3"
"695","1623",12413.5770768077,61816.2421888281,57,97,0.635150464251637,40,14.5939814299345,"Q3"
"696","1624",16173.5043995019,61746.1342875923,51,101,0.290349461371079,50,35.482526931446,"Q1"
"697","1625",12094.8612815169,61826.3224652736,84,156,0.995140953687951,72,0.34985133446753,"Q4"
"698","1626",18848.0775818376,61681.576870429,68,124,0.11588565306738,56,49.5104034282267,"Q1"
"699","1627",12374.7183412225,61819.7530324311,68,106,0.738958836067468,38,9.91956422943622,"Q4"
"700","1628",12515.7946222591,61813.0910973998,66,104,0.581608048407361,38,15.8988941605203,"Q3"
"701","1629",12362.028641797,61817.6314262365,46,97,0.715232308255509,51,14.5231522789691,"Q3"
"702","163",12244.0123472803,61824.1482372655,52,120,0.916127827484161,68,5.70330773107708,"Q4"
"703","1630",14550.4127440088,61783.162839627,68,100,0.28662406723015,32,22.8280298486352,"Q2"
"704","1631",12486.2547325469,61812.0714168952,52,100,0.599183813668787,48,19.2391769438982,"Q3"
"705","1632",12473.7805664896,61813.5893081134,35,87,0.703614089870825,52,15.4120673267171,"Q3"
"706","1633",12104.6758178168,61826.3224652736,48,93,0.969561049016193,45,1.36975279427134,"Q4"
"707","1634",15661.406965642,61743.1002863277,66,121,0.390947419917211,55,33.4978919045534,"Q1"
"708","1635",16325.0524536387,61722.731699876,50,118,0.396178552182391,68,41.0598584515974,"Q1"
"709","1636",15490.2198957686,61770.80013607,58,94,0.198295856127515,36,28.8613491794094,"Q2"
"710","1637",13613.3338790556,61785.637304462,54,113,0.505883808014914,59,29.1528553271201,"Q2"
"711","1638",19603.7286792335,61680.5206656509,49,109,0.0858634389005601,60,54.8481936659664,"Q1"
"712","1639",15302.1379853286,61763.7223627246,42,90,0.397236875724047,48,28.9326299652457,"Q2"
"713","164",12178.1007681118,61825.4385036253,66,117,0.939812198281288,51,3.0695778876543,"Q4"
"714","1640",13994.2590667409,61784.1638751517,64,109,0.452247030567378,45,24.648883624468,"Q2"
"715","1641",18666.5718459493,61656.0295325706,64,131,0.250626654364169,67,50.2080141576007,"Q1"
"716","1642",13731.5676219256,61795.3193934363,63,95,0.382099482929334,32,19.7728165462613,"Q2"
"717","1643",12274.4030588663,61822.8708891026,55,108,0.861960292095318,53,7.31610451894812,"Q4"
"718","1644",12489.593541391,61816.5808876118,71,114,0.703491573221982,43,12.7498623514548,"Q3"
"719","1645",12702.782757621,61810.2502820132,76,129,0.676551933865994,53,17.1427475051023,"Q3"
"720","1646",12292.0587945276,61821.8659797989,59,100,0.797750785714015,41,8.29221778572537,"Q4"
"721","1647",18396.3700010269,61716.2046869526,66,114,0.0361150910612196,48,46.2664756290615,"Q1"
"722","1648",19413.552619277,61638.8294155201,78,139,0.136853250907734,61,52.6519516946282,"Q1"
"723","1649",12304.7683360782,61821.3739263246,50,102,0.812705849995837,52,9.7392958002165,"Q4"
"724","165",12603.9678149566,61809.2300969035,53,94,0.523464670637622,41,19.5379485038575,"Q3"
"725","1650",14407.1142083069,61770.0880384526,77,127,0.477384799858555,50,26.1307600070722,"Q2"
"726","1651",12598.4252079885,61811.1032533576,57,113,0.648698692442849,56,19.6728732232004,"Q3"
"727","1652",16439.6032054275,61753.747119861,53,95,0.165688052074984,42,35.0411018128507,"Q2"
"728","1653",12324.1847860501,61814.1416942099,46,84,0.555583582026884,38,16.8878238829784,"Q3"
"729","1654",14900.2142610044,61783.8223815308,46,77,0.222662796964869,31,24.0974532940891,"Q2"
"730","1655",12675.6330593839,61811.9042770039,77,132,0.712590839248151,55,15.8075038413517,"Q3"
"731","1656",12208.243561818,61823.6476180867,55,90,0.831332056550309,35,5.90337802073918,"Q4"
"732","1657",16892.5734478989,61754.964082044,52,92,0.0696624205447733,40,37.2135031782091,"Q2"
"733","1658",14693.1652974775,61784.0690484152,52,85,0.255934278247878,33,24.55416881782,"Q2"
"734","1659",13858.7939176231,61780.649160346,63,121,0.512569028651342,58,28.2709963382222,"Q2"
"735","166",14710.9441083446,61752.3404924763,48,125,0.490090635372326,77,39.2630210763309,"Q2"
"736","1660",12650.4517673112,61809.0192274381,62,115,0.616495631402358,53,20.325731535675,"Q3"
"737","1661",15027.9978126633,61755.133373267,55,117,0.444811498047784,62,34.4216871210374,"Q2"
"738","1662",12601.42652874,61806.9456010351,50,108,0.586475122254342,58,23.9844429092482,"Q3"
"739","1663",12192.6127125315,61824.9868136186,79,117,0.918234643293545,38,3.1070835548453,"Q4"
"740","1664",12665.3609498091,61812.5307203879,59,132,0.753204804845154,73,18.0160492463037,"Q3"
"741","1665",12987.8747868189,61803.6432829293,60,100,0.501283096149564,40,19.9486761540174,"Q3"
"742","1666",17188.7426385701,61711.1204707799,58,117,0.28969301446341,59,41.9081121466588,"Q1"
"743","1667",16070.2570965411,61733.7773747491,50,113,0.386139040347189,63,38.6732404581271,"Q1"
"744","1668",12238.9295100324,61823.8044234134,60,108,0.882671741768718,48,5.63175639510155,"Q4"
"745","1669",12786.8474375854,61806.0021147786,66,112,0.562684753676876,46,20.1165013308637,"Q3"
"746","167",15419.2705135672,61766.4566580871,55,96,0.271696681389585,41,29.860436063027,"Q2"
"747","1670",15676.6362369677,61764.6718493565,58,97,0.219903401099145,39,30.4237673571333,"Q2"
"748","1671",12250.0673697793,61821.9317525937,55,87,0.742026654770598,32,8.25514704734087,"Q4"
"749","1672",20407.3840921636,61636.9372261286,60,126,0.0883155236952007,66,60.1711754361168,"Q1"
"750","1673",14643.3043629605,61783.810082434,61,93,0.258862873073667,32,23.7163880616426,"Q2"
"751","1674",12597.3640077793,61809.9998824322,60,102,0.553942090133205,42,18.7344322144054,"Q3"
"752","1675",21877.3696403612,61573.8272366972,58,134,0.0800806467887014,76,69.9138708440587,"Q1"
"753","1676",17751.890355958,61730.6845876531,50,98,0.10489863040857,48,42.9648657403886,"Q1"
"754","1677",16855.3224208222,61750.6132151989,52,94,0.112765918718651,42,37.2638314138167,"Q2"
"755","1678",17323.5898130753,61728.3068947784,64,111,0.148076309589669,47,40.0404134492856,"Q1"
"756","1679",17654.7934028428,61701.3098928983,59,118,0.252814109437168,59,44.0839675432071,"Q1"
"757","168",16499.9372502469,61709.2990591894,61,131,0.411870863521472,70,41.169039553497,"Q1"
"758","1680",14950.3224353379,61780.5183304904,49,83,0.242698837304488,34,25.7482395316474,"Q2"
"759","1681",13694.8994307149,61785.0628131937,61,117,0.510537500027567,56,27.4098999984562,"Q2"
"760","1682",18368.9541505088,61657.7573218712,66,134,0.284388451371342,68,48.6615853067487,"Q1"
"761","1683",12857.8515500552,61807.4939237577,60,94,0.487216169480234,34,17.434650237672,"Q3"
"762","1684",12776.4197230823,61803.3184128336,55,111,0.560757922241464,56,24.597556354478,"Q3"
"763","1685",12122.7592144501,61826.1685284486,60,102,0.959473950089887,42,1.70209409622476,"Q4"
"764","1686",13461.4824692545,61799.7964812931,54,86,0.39364347839728,32,19.403408691287,"Q3"
"765","1687",13965.761774678,61790.4838630482,51,88,0.378104276722297,37,23.010141761275,"Q2"
"766","1688",12357.3285658374,61820.6134559782,52,111,0.819975787773728,59,10.62142852135,"Q4"
"767","1689",12396.5764005492,61816.9388352061,58,96,0.638751494931057,38,13.7274431926198,"Q3"
"768","169",12422.3451826611,61816.2020392094,66,98,0.590502915903926,32,13.1039066910744,"Q3"
"769","1690",12401.3397266975,61814.9641274537,52,93,0.601802113698795,41,16.3261133383494,"Q3"
"770","1691",14802.5469590795,61765.6488785657,60,112,0.422104916768149,52,30.0505443280563,"Q2"
"771","1692",14334.3403958646,61783.567444799,49,89,0.369271060684696,40,25.2291575726122,"Q2"
"772","1693",12253.982537385,61824.0217805269,67,123,0.909036943223327,56,5.09393117949367,"Q4"
"773","1694",12425.9253202461,61815.8499267399,53,99,0.658539190422744,46,15.7071972405538,"Q3"
"774","1695",15034.468116652,61779.632581159,34,66,0.368530432926491,32,20.2070261463523,"Q2"
"775","1696",17456.2985589903,61699.9354861161,50,116,0.319310173857957,66,44.9255285253748,"Q1"
"776","1697",12390.9439224218,61817.643540526,45,104,0.750869712792337,59,14.6986869452521,"Q3"
"777","1698",16576.8493288989,61745.6047859954,63,106,0.175585475750268,43,35.4498245427385,"Q1"
"778","1699",12498.663704416,61811.8588768569,53,101,0.598142840666696,48,19.2891436479986,"Q3"
"779","17",13642.2985422634,61781.3256492903,46,111,0.500420443946496,65,32.4726711434778,"Q2"
"780","170",12586.880694218,61808.1333968653,53,106,0.577952206833288,53,22.3685330378357,"Q3"
"781","1700",12697.6572555652,61812.5394499006,74,145,0.783383866073564,71,15.379745508777,"Q3"
"782","1701",14248.4460314084,61784.0222187787,60,99,0.380883830133826,39,24.1455306247808,"Q2"
"783","1702",16044.301862042,61739.4786048712,60,114,0.343322435161099,54,35.4605885013007,"Q1"
"784","1703",13291.8140481111,61793.7971023104,61,115,0.52963636117056,54,25.3996364967898,"Q2"
"785","1704",15860.7393182323,61742.5072322253,59,114,0.362850459991023,55,35.0432247004937,"Q1"
"786","1705",12244.8247248626,61821.4556087135,44,89,0.786787205608562,45,9.59457574761473,"Q4"
"787","1706",15506.802222254,61744.8682483378,55,117,0.418625628575683,62,36.0452110283077,"Q1"
"788","1707",12290.627846052,61821.1352094601,56,93,0.746838927268982,37,9.36695969104767,"Q4"
"789","1708",12245.5131759807,61824.211537313,57,122,0.917375351069495,65,5.37060218048282,"Q4"
"790","1709",16630.0998918213,61731.0226321942,50,106,0.305265093455091,56,38.9051547665149,"Q1"
"791","171",12135.3649777948,61826.1465357265,52,109,0.960549513576552,57,2.24867772613652,"Q4"
"792","1710",12095.8356860053,61826.3224652736,54,91,0.97724799416028,37,0.841824216069654,"Q4"
"793","1711",14494.0338522999,61777.3074439037,69,109,0.384675909299403,40,24.6129636280239,"Q2"
"794","1712",12318.7441433436,61817.1095805938,52,84,0.573237848933786,32,13.6563888341188,"Q3"
"795","1713",12185.9115450291,61824.0630453073,54,86,0.836892596445978,32,5.21943691372871,"Q4"
"796","1714",14336.6941521495,61766.1413829868,59,126,0.505135314306244,67,33.1559339414816,"Q2"
"797","1715",19258.0935807653,61657.5469649678,66,128,0.150875270133838,62,52.645733251702,"Q1"
"798","1716",12307.8344361725,61822.3730816808,61,114,0.856758618028834,53,7.59179324447177,"Q4"
"799","1717",15098.5218532043,61780.1458323455,57,89,0.18450766778551,32,26.0957546308637,"Q2"
"800","1718",12891.5944308465,61799.2544888302,55,122,0.58432229841128,67,27.8504060064442,"Q3"
"801","1719",19208.9242356628,61702.2140441539,54,108,0.0316586077678949,54,52.2904351805337,"Q1"
"802","172",16068.4283037644,61714.8005202704,60,136,0.456737876404077,76,41.2879213932902,"Q1"
"803","1720",12245.825604255,61822.8461541359,47,99,0.851234301924706,52,7.73581629991531,"Q4"
"804","1721",16640.8868232365,61748.7467397413,56,99,0.157908066175878,43,36.2099531544372,"Q2"
"805","1722",12625.6640860048,61811.4686806001,62,118,0.668510154122487,56,18.5634313691407,"Q3"
"806","1723",19368.1489905256,61675.6914720965,43,105,0.166242772247642,62,51.6929481206462,"Q1"
"807","1724",13447.8803824055,61786.261716878,59,126,0.550445095170289,67,30.1201786235906,"Q2"
"808","1725",13982.7005214272,61790.9414210224,47,83,0.380018042400479,36,22.3193504735827,"Q2"
"809","1726",14327.1674656369,61766.7581742973,63,128,0.509471894707531,65,31.8843268440105,"Q2"
"810","1727",13775.6946636611,61781.9620975736,63,122,0.520480121020228,59,28.2916728598066,"Q2"
"811","1728",12235.0801076055,61822.3991403973,52,87,0.774545471183956,35,7.89090850856155,"Q4"
"812","1729",17189.634002101,61667.0801330888,81,151,0.403150419238955,70,41.7794706532732,"Q1"
"813","173",18524.9001720381,61723.4666656266,52,101,0.0254136987496167,49,47.7547287612688,"Q1"
"814","1730",12242.6879164961,61823.9583472734,73,116,0.889775026123971,43,4.73967387666926,"Q4"
"815","1731",16261.1009399669,61733.2520616604,57,114,0.344024498015642,57,37.3906036131084,"Q1"
"816","1732",13314.9654672819,61791.414015388,73,133,0.579429767327383,60,25.234213960357,"Q2"
"817","1733",16830.9234275074,61757.6971775421,48,87,0.0696342962328345,39,36.2842624469195,"Q2"
"818","1734",12600.2144574584,61813.632285193,54,124,0.743820531060919,70,17.9325628257357,"Q3"
"819","1735",12573.0039412155,61813.0031695183,67,114,0.652124929241836,47,16.3501283256337,"Q3"
"820","1736",15059.2286542693,61770.4083764192,44,88,0.369033752940595,44,27.7625148706138,"Q2"
"821","1737",12213.7356922428,61825.1760533675,73,134,0.942666636547074,61,3.4973351706285,"Q4"
"822","1738",19962.0299890999,61672.8520265804,63,121,0.0223810479510576,58,56.7018992188387,"Q1"
"823","1739",21666.6613082335,61566.5851268448,62,138,0.100042887032032,76,68.3967405855656,"Q1"
"824","174",16585.8984166223,61719.3338836669,62,122,0.349751895759255,60,39.0148862544447,"Q1"
"825","1740",19708.531453362,61691.3035379665,50,107,0.0285515957511961,57,55.3725590421818,"Q1"
"826","1741",12624.0963878739,61811.2721674017,63,117,0.657131500076503,54,18.5148989958689,"Q3"
"827","1742",14907.0699955561,61764.4809717126,57,109,0.408597478410229,52,30.7529311226681,"Q2"
"828","1743",17216.0981196409,61719.468549833,58,112,0.240108160767704,54,41.034159318544,"Q1"
"829","1744",12256.9450349,61822.8267073035,57,99,0.830022596521303,42,7.13905094610527,"Q4"
"830","1745",18567.9580181221,61667.3052259248,48,119,0.284740000031888,71,50.7834599977359,"Q1"
"831","1746",12135.4783328786,61825.3998616349,47,86,0.918901347089559,39,3.16284746350721,"Q4"
"832","1747",13234.2840005947,61801.2066471245,52,88,0.439664189470932,36,20.1720891790465,"Q3"
"833","1748",21119.2344190838,61485.5486397342,91,166,0.156845018267632,75,63.2366236299276,NA
"834","1749",15000.8183379412,61780.2765051609,39,71,0.316644167527556,32,21.8673866391182,"Q2"
"835","175",12534.323151517,61816.031756061,93,164,0.872215680312365,71,9.07268669782206,"Q3"
"836","1750",12134.4001462131,61826.0411889042,60,106,0.955431640380993,46,2.0501445424743,"Q4"
"837","1751",12169.4613387315,61825.3779889648,65,109,0.931548595428467,44,3.01186180114746,"Q4"
"838","1752",14945.3038398595,61778.0852020322,69,101,0.230968359392136,32,24.6090124994516,"Q2"
"839","1753",15879.5618617563,61761.7014701831,56,96,0.206626715837047,40,31.7349313665181,"Q2"
"840","1754",16616.5491102997,61753.7657645982,54,95,0.126470312708989,41,35.8147171789315,"Q2"
"841","1755",15570.6850440374,61756.1046280615,67,111,0.309075664263219,44,30.4006707724184,"Q2"
"842","1756",21513.9671968694,61589.0289532257,49,126,0.120862920768559,77,67.693555100821,"Q1"
"843","1757",12544.437581398,61813.0779365983,60,91,0.514315485954285,31,15.0562199354172,"Q3"
"844","1758",13129.8139850993,61797.9920571796,56,106,0.514356202445924,50,24.2821898777038,"Q3"
"845","1759",12088.792789985,61826.3224652736,50,84,0.982474148273468,34,0.595878958702087,"Q4"
"846","176",18229.2363508263,61641.9344112258,67,143,0.351650069002062,76,49.2745947558433,"Q1"
"847","1760",22465.4125942415,61554.9380088279,61,138,0.0469032800756395,77,73.3884474341758,"Q1"
"848","1761",17009.856812864,61696.7328523751,49,125,0.397345827659592,76,45.801717097871,"Q1"
"849","1762",16965.0957597522,61705.2407242371,46,118,0.390381918055937,72,43.8925018999726,"Q1"
"850","1763",12292.4410884228,61822.5490115425,66,110,0.842088964534923,44,6.94808556046337,"Q4"
"851","1764",12106.7780163114,61826.3224652736,49,110,0.980974270030856,61,1.16056952811778,"Q4"
"852","1765",14754.9692811539,61769.9388276209,58,106,0.397693038685247,48,28.9107341431081,"Q2"
"853","1766",12417.9349897119,61818.5165192574,57,109,0.757198985200375,52,12.6256527695805,"Q3"
"854","1767",12483.5643260629,61818.9178058987,67,138,0.848038943251595,71,10.7892350291368,"Q3"
"855","1768",12409.1997147484,61819.3150228257,46,119,0.82736914162524,73,12.6020526613574,"Q4"
"856","1769",18322.2406357576,61660.3325637285,65,133,0.286503605777398,68,48.517754807137,"Q1"
"857","177",12262.6214275798,61823.5022547432,53,115,0.894096699776128,62,6.56600461388007,"Q4"
"858","1770",14542.8106962557,61771.8371290311,49,102,0.426069111330435,53,30.418337099487,"Q2"
"859","1771",12254.0528206744,61822.682724094,44,103,0.862828091485426,59,8.09314260235988,"Q4"
"860","1772",16465.8151549213,61766.1452766039,50,86,0.0519482165109366,36,34.1298642056063,"Q2"
"861","1773",19437.4742735103,61669.7523591808,73,129,0.0588317890651524,56,52.7054198123515,"Q1"
"862","1774",18589.7864035524,61689.309033509,64,120,0.137641926528886,56,48.2920521143824,"Q1"
"863","1775",12499.1022916017,61814.8177024575,56,108,0.682536666281521,52,16.5080933533609,"Q3"
"864","1776",12424.5930957989,61816.6701199705,64,100,0.633526914287359,36,13.1930310856551,"Q3"
"865","1777",12436.5718813762,61819.2288156327,61,121,0.810599691001698,60,11.3640185398981,"Q4"
"866","1778",12181.2066146536,61825.2339735985,55,111,0.933320980984718,56,3.73402506485581,"Q4"
"867","1779",14337.1065902625,61780.9673276158,81,115,0.368470941204578,34,21.4719879990444,"Q2"
"868","178",20557.2391624655,61622.0588558766,70,135,0.0717998356558383,65,60.3330106823705,"Q1"
"869","1780",15582.5749398852,61764.1347519914,59,99,0.246561417123303,40,30.1375433150679,"Q2"
"870","1781",16735.9212012431,61712.1323487873,56,122,0.368298440938815,66,41.6923028980382,"Q1"
"871","1782",17644.9151784431,61732.6773446413,35,80,0.183347465237603,45,36.7493640643079,"Q1"
"872","1783",13595.0325532405,61794.2085064315,49,89,0.428119082003832,40,22.8752367198467,"Q2"
"873","1784",12165.9549714126,61825.0601408304,54,96,0.910603710683063,42,3.75464415131137,"Q4"
"874","1785",12205.8367715781,61825.2185468129,54,126,0.942915499443188,72,4.11008404009044,"Q4"
"875","1786",12314.2532158969,61822.4670699344,61,119,0.870976550970227,58,7.48336004372686,"Q4"
"876","1787",12726.8846022139,61808.6652655525,65,126,0.668236852856353,61,20.2375519757625,"Q3"
"877","1788",15509.9326033745,61774.7515274991,59,92,0.142077370313928,33,28.3114467796404,"Q2"
"878","1789",18577.2706836323,61676.1915242468,58,121,0.212962761288509,63,49.5833460388239,"Q1"
"879","179",12427.2561585017,61820.2373307073,60,133,0.861251652473584,73,10.1286293694284,"Q4"
"880","1790",12657.4781201788,61805.2245567203,51,107,0.562369134509936,56,24.5073284674436,"Q3"
"881","1791",17078.2934018639,61710.085037108,66,123,0.293163871858269,57,40.2896593040787,"Q1"
"882","1792",12401.6807288058,61817.2596178323,48,102,0.723390209488571,54,14.9369286876172,"Q3"
"883","1793",12248.252044161,61824.3326187334,55,127,0.925645664799958,72,5.35351213440299,"Q4"
"884","1794",13544.334110821,61787.4053144669,56,114,0.512160753598437,58,28.2946762912907,"Q2"
"885","1795",12409.1329422688,61816.489010444,53,98,0.665666298242286,45,15.0450165790971,"Q3"
"886","1796",12230.0663864706,61825.1606167577,64,141,0.947654067073017,77,4.03063683537766,"Q4"
"887","1797",12300.694669156,61822.6531586781,59,116,0.870623807189986,57,7.37444299017079,"Q4"
"888","1798",15483.3763851925,61762.1572550015,70,109,0.265262824250385,39,28.654749854235,"Q2"
"889","1799",16385.1387231902,61759.3599295397,68,104,0.0813470941502601,36,33.0715046105906,"Q2"
"890","18",16187.6335865834,61762.4478730627,55,93,0.131978318328038,38,32.9848239035346,"Q2"
"891","180",17524.1513804056,61715.3812757209,43,100,0.278692242922261,57,41.1145421534311,"Q1"
"892","1800",12155.2385096835,61824.702562039,50,82,0.867367554223165,32,4.24423826485872,"Q4"
"893","1801",13005.0734327173,61800.1630649886,55,105,0.520723253954202,50,23.9638373022899,"Q3"
"894","1802",20316.0860290377,61623.5257965615,63,131,0.123364750994369,68,59.6111969323829,"Q1"
"895","1803",12277.922947066,61819.7076348449,43,90,0.747496886644512,47,11.8676463277079,"Q4"
"896","1804",14913.2237180563,61778.1448562167,59,94,0.261682792799547,35,25.8411022520158,"Q2"
"897","1805",17323.5221084268,61744.8523714617,59,101,0.0530414811801165,42,39.7722577904351,"Q1"
"898","1806",19152.1702218853,61645.0116226316,50,124,0.263419329887256,74,54.5069695883431,"Q1"
"899","1807",20674.9998978484,61618.28562802,53,125,0.130559915211052,72,62.5996861048043,"Q1"
"900","1808",14695.7615442869,61782.3507686535,45,80,0.314845421817154,35,23.9804102363996,"Q2"
"901","1809",14271.6656326706,61764.7900417741,55,128,0.514167428715155,73,35.4657777037937,"Q2"
"902","181",12838.3619328673,61801.5899595916,56,126,0.615249666851014,70,26.932523320429,"Q3"
"903","1810",12331.5363830965,61818.4754849258,56,89,0.632067014463246,33,12.1417885227129,"Q3"
"904","1811",12267.9627885561,61815.6714546459,43,80,0.590072961291298,37,15.167300432222,"Q3"
"905","1812",14889.1358198119,61766.3125518309,57,107,0.398158950731158,50,30.0920524634421,"Q2"
"906","1813",12407.9287899482,61815.7769616175,52,96,0.641320766648278,44,15.7818862674758,"Q3"
"907","1814",12450.1123274115,61819.6141168211,59,133,0.85249031893909,74,10.9157163985074,"Q4"
"908","1815",16547.068787187,61713.1138925803,61,127,0.388321023434401,66,40.3708124533296,"Q1"
"909","1816",12184.9782380013,61823.5169004808,47,82,0.819227612577379,35,6.32703355979174,"Q4"
"910","1817",13148.5680659541,61798.712211194,68,115,0.536831230390817,47,21.7689321716316,"Q3"
"911","1818",13002.9456799462,61801.6948020321,55,100,0.504646480781958,45,22.2909083648119,"Q3"
"912","1819",17876.1152423107,61737.1405209277,54,99,0.0323865774553269,45,43.5426040145103,"Q1"
"913","182",17098.4535543222,61712.4410844648,52,114,0.314769674092531,62,42.4842802062631,"Q1"
"914","1820",12301.5035750036,61820.4786675125,59,91,0.696303830482066,32,9.7182774245739,"Q4"
"915","1821",19232.5778311886,61651.0887568178,75,135,0.138601870043203,60,51.6838877974078,"Q1"
"916","1822",12580.0210312142,61813.12294625,55,117,0.704287952044979,62,18.3341469732113,"Q3"
"917","1823",18144.1384278,61670.8809471774,62,129,0.287599467672408,67,47.7308356659487,"Q1"
"918","1824",22126.8131610078,61569.193403956,59,135,0.0609092090744525,76,71.3709001103416,"Q1"
"919","1825",14476.4872035033,61779.8710585569,52,94,0.369751708814874,42,26.4704282297753,"Q2"
"920","1826",14650.7379802988,61780.5764778725,59,95,0.306491765659302,36,24.9662964362651,"Q2"
"921","1827",14514.1985066376,61758.1544767438,60,133,0.516104362672195,73,35.3243815249298,"Q2"
"922","1828",12569.4630987276,61814.0233364142,52,120,0.736806463217363,68,17.8971605012193,"Q3"
"923","1829",17220.3624613188,61711.5315729029,52,113,0.298573686741292,61,42.7870051087812,"Q1"
"924","183",12377.700124038,61819.9825800771,61,109,0.781013978179544,48,10.5113290473819,"Q4"
"925","1830",18264.7454426839,61690.2552905565,57,117,0.20795772690326,60,47.5225363858044,"Q1"
"926","1831",13396.62774395,61796.020681232,64,106,0.485222649760544,42,21.6206487100571,"Q2"
"927","1832",16644.4978776022,61763.8853345767,45,81,0.0565848425030708,36,33.9629456698895,"Q2"
"928","1833",18146.9286985879,61734.5953056087,48,94,0.0269161884207278,46,44.7618553326465,"Q1"
"929","1834",18332.9372317212,61693.9837529207,60,117,0.170989035395905,57,47.2536249824334,"Q1"
"930","1835",20453.3572059261,61645.9662037002,57,122,0.0686783031560481,65,60.5359102948569,"Q1"
"931","1836",12208.4029305529,61822.8976224495,50,83,0.782321064034477,33,7.18340488686226,"Q4"
"932","1837",12188.1328919051,61825.3549733352,53,119,0.942444804357365,66,3.79864291241392,"Q4"
"933","1838",18548.972424231,61719.4483138117,53,103,0.0400588628835976,50,47.9970568558201,"Q1"
"934","1839",12114.0373219294,61826.0473749125,57,89,0.949079039506614,32,1.62947073578835,"Q4"
"935","184",15601.2859508981,61766.8586026699,54,93,0.224831642117351,39,30.2315659574233,"Q2"
"936","1840",16824.8909645737,61738.9116918595,53,101,0.205541551811621,48,38.1340055130422,"Q1"
"937","1841",14770.9095831393,61775.4587783893,74,109,0.31014444003813,35,24.1449445986655,"Q2"
"938","1842",15864.514037183,61752.369245397,65,109,0.274550564121455,44,31.919775178656,"Q2"
"939","1843",12392.4260741324,61817.7425262276,66,98,0.63122291257605,32,11.8008667975664,"Q3"
"940","1844",16664.427900846,61720.3404247512,82,130,0.262786992359906,48,35.3862243667245,"Q1"
"941","1845",18016.2452270091,61729.6013431288,60,106,0.0390292366500944,46,44.2046551140957,"Q1"
"942","1846",15079.725449238,61772.4515448892,44,85,0.343620697734877,41,26.91155139287,"Q2"
"943","1847",12100.6921885177,61826.3224652736,51,89,0.969160754466429,38,1.17189133027568,"Q4"
"944","1848",12773.16992758,61805.877131678,58,126,0.652420076308772,68,23.6354348110035,"Q3"
"945","1849",16653.6173311372,61720.861273783,40,108,0.432487242855132,68,38.590867485851,"Q1"
"946","185",13338.7885388121,61796.5542186723,48,91,0.458955054869875,43,23.2649326405954,"Q2"
"947","1850",12216.1999088053,61824.2842673208,54,107,0.901149983517826,53,5.23905087355524,"Q4"
"948","1851",12096.9853689303,61826.3224652736,53,124,0.991215554764494,71,0.623695611720905,"Q4"
"949","1852",17452.0913959035,61724.6566889766,50,102,0.193440634058788,52,41.941087028943,"Q1"
"950","1853",15586.158581225,61728.7772248321,64,137,0.477029975038022,73,38.1768118222244,"Q1"
"951","1854",16267.4713388056,61766.249537943,54,90,0.0792928047012538,36,33.1454590307549,"Q2"
"952","1855",12329.2390664938,61818.9468884954,58,90,0.642822476802394,32,11.4296807423234,"Q4"
"953","1856",12145.6023353457,61825.201969007,44,90,0.919504163553938,46,3.70280847651884,"Q4"
"954","1857",12155.6498181619,61825.7248106249,60,110,0.946087066316977,50,2.69564668415114,"Q4"
"955","1858",12602.6779551625,61809.6292376837,56,97,0.534212118247524,41,19.0973031518515,"Q3"
"956","1859",15568.2288853427,61776.3016921749,50,83,0.131305594928563,33,28.6669153673574,"Q2"
"957","186",12165.9965343208,61825.162532087,70,101,0.905980065464973,31,2.91461797058582,"Q4"
"958","1860",12259.704570558,61823.2921778686,63,108,0.863092005485669,45,6.1608597531449,"Q4"
"959","1861",12093.2447404223,61826.3224652736,56,115,0.991138635436073,59,0.522820509271696,"Q4"
"960","1862",14557.4272283728,61768.6737301425,56,112,0.448382308008149,56,30.8905907515436,"Q2"
"961","1863",12666.3016876016,61811.0040244906,55,125,0.712126481579617,70,20.1511462894268,"Q3"
"962","1864",13244.9689225184,61802.5435855724,59,91,0.429067268967628,32,18.2698473930359,"Q3"
"963","1865",16826.9589963496,61731.1135983018,52,105,0.260931150987744,53,39.1706489976496,"Q1"
"964","1866",12093.16082979,61826.3224652736,62,99,0.984548297012225,37,0.571713010547683,"Q4"
"965","1867",12162.6410830772,61825.0013839879,48,94,0.91161051671952,46,4.06591623090208,"Q4"
"966","1868",12589.1827679143,61814.2029155307,66,123,0.725180408917367,57,15.6647166917101,"Q3"
"967","1869",18003.8537333027,61711.5358829885,49,104,0.177891337079927,55,45.215976460604,"Q1"
"968","187",15256.4861185654,61771.0311753731,54,93,0.265295427758247,39,28.6534783174284,"Q2"
"969","1870",15379.8711366004,61740.0496275863,57,127,0.461289530154318,70,37.7097328891978,"Q1"
"970","1871",15438.1092962151,61770.7364531022,50,88,0.233837995445356,38,29.1141561730765,"Q2"
"971","1872",12227.0641156274,61822.8052428579,46,92,0.832314773229882,46,7.71352043142542,"Q4"
"972","1873",17621.3062578026,61720.6043773548,73,119,0.108222574461251,46,41.0217615747824,"Q1"
"973","1874",12517.0333581203,61812.9265076044,57,105,0.627367436885834,48,17.88636302948,"Q3"
"974","1875",12699.4180726596,61812.6402713327,74,149,0.799309193855152,75,15.0518104608636,"Q3"
"975","1876",19499.5606568947,61656.1419017149,70,130,0.106915096286684,60,53.5850942227989,"Q1"
"976","1877",16408.2366655868,61764.1076695976,51,88,0.0808279272168875,37,34.0093666929752,"Q2"
"977","1878",14048.7952349215,61789.0883324756,54,91,0.372602387331426,37,23.2137116687372,"Q2"
"978","1879",12302.2166437308,61822.9015324168,53,123,0.89371874043718,70,7.43968816939741,"Q4"
"979","188",12625.8474148149,61811.8315603098,77,111,0.572144391015172,34,14.5470907054842,"Q3"
"980","1880",19099.9903289731,61640.4815876541,64,133,0.234703408088535,69,52.8054648418911,"Q1"
"981","1881",12324.7288789756,61819.145521776,57,90,0.655263185733929,33,11.3763148707803,"Q4"
"982","1882",12313.7538058224,61819.1603598661,52,89,0.676119151292369,37,11.9835914021824,"Q4"
"983","1883",12091.4059966673,61826.3224652736,30,76,0.969181468011811,46,1.41765247145668,"Q4"
"984","1884",16795.6888454195,61685.1862109944,68,145,0.440593193285167,77,43.0743241170421,"Q1"
"985","1885",15156.6300152633,61768.6755059518,48,92,0.333249507006258,44,29.3370216917247,"Q2"
"986","1886",12156.8517901077,61825.3712836615,52,99,0.928507138509303,47,3.36016449006274,"Q4"
"987","1887",20940.772385504,61663.2308038214,39,100,0.0302111515775323,61,59.1571197537705,"Q1"
"988","1888",15977.79967875,61759.2082322278,63,102,0.189404223347083,39,31.6132352894638,"Q2"
"989","1889",16521.8484953484,61752.7650043974,58,99,0.14272437710315,41,35.1483005387709,"Q2"
"990","189",12505.1809335479,61817.535119202,73,127,0.782731481594965,54,11.7324999938719,"Q3"
"991","1890",12747.5989239844,61807.7375580223,59,127,0.675524279475212,68,22.0643489956856,"Q3"
"992","1891",19660.9516551512,61644.2388425208,54,123,0.181130547542125,69,56.5019922195934,"Q1"
"993","1892",12236.8657054245,61824.2836571221,84,127,0.909184699645266,43,3.90505791525356,"Q4"
"994","1893",14342.5007464385,61781.9157568992,40,84,0.466783092357218,44,23.4615439362824,"Q2"
"995","1894",18218.6631781569,61701.9324319378,59,114,0.156042495975271,55,46.4176627213601,"Q1"
"996","1895",15898.1313795109,61770.9400476719,41,74,0.163430952467024,33,27.6067785685882,"Q2"
"997","1896",14603.8792628866,61781.6474486924,57,93,0.308338811155409,36,24.8998027984053,"Q2"
"998","1897",12932.8220488315,61806.3610176097,60,94,0.478793776594102,34,17.7210115958005,"Q3"
"999","1898",12284.8546963545,61821.9435442794,62,98,0.781422204570845,36,7.86880063544959,"Q4"
"1000","1899",19623.425358139,61614.7045399844,59,135,0.249497293261811,76,57.0382057121024,"Q1"
"1001","19",12222.7793545296,61824.1464512223,62,107,0.889033265644684,45,4.9935030459892,"Q4"
"1002","190",15212.5821617645,61773.0789748534,52,90,0.257848468609154,38,28.2017581928521,"Q2"
"1003","1900",12274.2694960474,61823.404045158,72,120,0.884305446175858,48,5.5533385835588,"Q4"
"1004","1901",14674.5542216642,61769.5312393245,57,108,0.419132497627288,51,29.6242426210083,"Q2"
"1005","1902",12217.9352726673,61824.747361059,55,120,0.928285469766706,65,4.6614444651641,"Q4"
"1006","1903",18660.2116719681,61663.1435365985,69,131,0.208706478122622,62,49.0601983563974,"Q1"
"1007","1904",12496.6999550687,61817.1549624147,59,120,0.773267780430615,61,13.8306653937325,"Q3"
"1008","1905",12729.2104105185,61810.6136746438,60,136,0.745114375837147,76,19.3713074363768,"Q3"
"1009","1906",12166.2443260847,61825.5242082282,53,110,0.941844974877313,57,3.31483643199317,"Q4"
"1010","1907",15257.250449228,61764.4466180986,59,103,0.325271843699738,44,29.6880388772115,"Q2"
"1011","1908",12383.4295174201,61813.3239260182,44,93,0.620749135734513,49,18.5832923490088,"Q3"
"1012","1909",18633.6922222663,61710.538775275,50,103,0.0828688514884561,53,48.6079508711118,"Q1"
"1013","191",13113.8241937379,61801.6364760079,45,83,0.467633719788864,38,20.2299186480232,"Q3"
"1014","1910",17263.318846372,61701.8178096723,49,117,0.345152008114383,68,44.529663448222,"Q1"
"1015","1911",19388.0423380613,61670.1627819832,45,109,0.172777400817722,64,52.9422463476658,"Q1"
"1016","1912",12405.3446887821,61819.2087484744,57,111,0.780532086966559,54,11.8512673038058,"Q4"
"1017","1913",12146.6695173578,61824.7153050081,47,79,0.867840840481222,32,4.22909310460091,"Q4"
"1018","1914",16804.3057013193,61716.6484457317,65,122,0.314613602822646,57,39.0670246391091,"Q1"
"1019","1915",12896.2936491689,61805.4913474202,50,87,0.471321921795607,37,19.5610888935626,"Q3"
"1020","1916",21014.819347142,61605.2500204138,58,130,0.105221642879769,72,64.4240417126566,"Q1"
"1021","1917",17509.9793741848,61687.5675298901,52,124,0.351950747193769,72,46.6595462020487,"Q1"
"1022","1918",12130.450808164,61826.2477225854,52,109,0.963705746456981,57,2.0687724519521,"Q4"
"1023","1919",16829.8141047586,61737.5450749342,68,112,0.167602522531524,44,36.6254890086129,"Q1"
"1024","192",13876.4331799601,61794.4359616876,59,90,0.344503360800445,31,20.3203958151862,"Q2"
"1025","1920",12081.6362370971,61826.3224652736,51,87,0.995509001659229,36,0.161675940267742,"Q4"
"1026","1921",18746.1968800457,61667.747680495,51,119,0.243163373786956,68,51.464890582487,"Q1"
"1027","1922",16588.5088793523,61736.1508384591,49,102,0.285517910029739,53,37.8675507684238,"Q1"
"1028","1923",16052.8681862483,61770.438728368,57,91,0.0716162833850831,34,31.5650463649072,"Q2"
"1029","1924",16035.2099104002,61740.2331758406,85,127,0.262973163742572,42,30.955127122812,"Q1"
"1030","1925",17252.0515761111,61714.1808252909,49,109,0.291860630270094,60,42.4883621837944,"Q1"
"1031","1926",13638.2203971873,61790.3725807483,53,100,0.461509684333578,47,25.3090448363218,"Q2"
"1032","1927",18505.7269686101,61711.0279701385,51,104,0.0952210265677422,53,47.9532855919097,"Q1"
"1033","1928",12111.3240147489,61825.9027660526,41,83,0.946757827652618,42,2.23617123859003,"Q4"
"1034","1929",12251.5564890431,61824.8326481788,74,150,0.946479432052001,76,4.0675631640479,"Q4"
"1035","193",17351.5615805843,61746.9742563915,55,97,0.0447661250364035,42,40.1198227484711,"Q2"
"1036","1930",12413.2788392619,61818.8997807422,67,110,0.744023829000071,43,11.006975352997,"Q3"
"1037","1931",16084.3133805366,61715.4514217571,60,135,0.452382427407429,75,41.0713179444429,"Q1"
"1038","1932",12188.2935046113,61824.8698615972,47,107,0.923484036233276,60,4.59095782600343,"Q4"
"1039","1933",12874.8718295687,61801.4227227928,62,127,0.608806937700137,65,25.4275490494911,"Q3"
"1040","1934",12174.2006646862,61825.3426056459,50,110,0.937631813576445,60,3.7420911854133,"Q4"
"1041","1935",16252.7868977496,61726.3752406916,57,120,0.38278813357465,63,38.8843475847971,"Q1"
"1042","1936",12773.5089432142,61804.8892834571,63,117,0.584393608849496,54,22.4427451221272,"Q3"
"1043","1937",16538.1781391948,61743.7943939551,41,89,0.301565243629739,48,33.5248683057725,"Q1"
"1044","1938",13151.4528536206,61803.538808927,52,85,0.430543988011777,33,18.7920483956113,"Q3"
"1045","1939",19931.5857538987,61649.2966624448,69,130,0.0767565865535289,61,56.3178482202347,"Q1"
"1046","194",17062.5773350779,61748.9537171814,63,103,0.0553389198612422,40,37.7864432055503,"Q2"
"1047","1940",12655.6538317337,61810.2358163257,56,120,0.677095492137596,64,20.6658885031939,"Q3"
"1048","1941",12447.4619867932,61813.8933014806,57,91,0.536495190579444,34,15.7591635202989,"Q3"
"1049","1942",13853.4910570383,61779.5550074391,52,114,0.496826327173039,62,31.1967677152716,"Q2"
"1050","1943",13116.1469007398,61804.2796856785,62,94,0.451800032053143,32,17.5423989742994,"Q3"
"1051","1944",17616.0614399565,61741.493807383,63,105,0.0169430475216359,42,41.2883920040913,"Q1"
"1052","1945",12664.7520294025,61810.9127010147,53,125,0.714614207623526,72,20.5477770511061,"Q3"
"1053","1946",12957.1053725123,61799.5156056831,65,128,0.598359440919012,63,25.3033552221023,"Q3"
"1054","1947",12249.3767293686,61822.517609992,53,93,0.805181178729981,40,7.79275285080075,"Q4"
"1055","1948",12281.2176095836,61821.6768128468,61,94,0.751746422378346,33,8.19236806151457,"Q4"
"1056","1949",14841.1930829546,61775.1176494471,69,105,0.303675314411521,36,25.0676886811852,"Q2"
"1057","195",12692.1492795569,61810.6203738947,57,128,0.716965588275343,71,20.0954432324506,"Q3"
"1058","1950",17110.7486363785,61710.153561057,55,117,0.315825255354866,62,42.4188341679983,"Q1"
"1059","1951",18262.4584700685,61672.9020166992,58,125,0.273786519188434,67,48.6563032143749,"Q1"
"1060","1952",15292.5390691068,61780.3005221478,56,87,0.131439486052841,31,26.9253759323619,"Q2"
"1061","1953",18566.6652339447,61680.9425880294,71,127,0.148645882727578,56,47.6758305672556,"Q1"
"1062","1954",12758.9599523385,61807.7727393443,50,86,0.480105777271092,36,18.7161920182407,"Q3"
"1063","1955",20530.7817855225,61619.8668896007,56,127,0.132488876348361,71,61.5932897792663,"Q1"
"1064","1956",12277.5043526741,61821.9321312472,56,96,0.789774692384526,40,8.40901230461895,"Q4"
"1065","1957",15656.9479204622,61764.392426784,43,84,0.295514435740188,41,28.8839081346523,"Q2"
"1066","1958",15287.8870168448,61750.3627206298,49,112,0.427255436079577,63,36.0829075269867,"Q2"
"1067","1959",12167.1429169839,61825.9800940105,65,127,0.958190076053143,62,2.59221528470516,"Q4"
"1068","196",17696.6370311728,61738.8334319709,51,96,0.057844580616802,45,42.3969938722439,"Q1"
"1069","1960",12370.7781690844,61820.7785644122,55,117,0.83665035944432,62,10.1276777144521,"Q4"
"1070","1961",14240.6360547036,61782.0848838248,35,85,0.547563433414325,50,22.6218283292837,"Q2"
"1071","1962",15713.5305638447,61753.1567645555,44,96,0.37274618120864,52,32.6171985771507,"Q2"
"1072","1963",17954.2484675284,61723.6229976282,56,105,0.0951465568505228,49,44.3378187143244,"Q1"
"1073","1964",15806.8769536664,61772.8069981114,53,87,0.109474146272987,34,30.2778790267184,"Q2"
"1074","1965",12110.0473834095,61826.2920582402,61,97,0.964484152384102,36,1.27857051417232,"Q4"
"1075","1966",12164.1055834646,61825.767049021,64,118,0.950247426517308,54,2.68663896806538,"Q4"
"1076","1967",15390.2023465297,61769.3630689721,54,93,0.249962510773912,39,29.2514620798174,"Q2"
"1077","1968",21095.3333328415,61606.142397218,46,121,0.142765985568985,75,64.2925510823261,"Q1"
"1078","1969",12145.2889369483,61825.324167688,56,89,0.908284532139078,33,3.02661043941043,"Q4"
"1079","197",12565.2707661981,61815.6112931452,69,127,0.758960827253759,58,13.980272019282,"Q3"
"1080","1970",17583.428587544,61731.9049606282,46,94,0.142345384228975,48,41.1674215570092,"Q1"
"1081","1971",12704.3060869392,61811.4094000794,58,135,0.752762779826298,77,19.037265953375,"Q3"
"1082","1972",18253.2696767317,61669.8870972416,57,126,0.288892733631656,69,49.0664013794158,"Q1"
"1083","1973",12328.5422942635,61820.5627882283,66,99,0.724767439300194,33,9.08267450309359,"Q4"
"1084","1974",20781.6142807433,61647.8524662839,58,122,0.0247271470725536,64,62.4174625873566,"Q1"
"1085","1975",14695.2882159091,61779.581455148,64,99,0.299060408258811,35,24.5328857109416,"Q2"
"1086","1976",21580.2818779589,61598.0229581654,53,127,0.0794261621776968,74,68.1224639988504,"Q1"
"1087","1977",12358.76422662,61818.4430663602,48,98,0.729668158339337,50,13.5165920830332,"Q3"
"1088","1978",12364.6515290278,61818.1657999527,61,94,0.637274419888854,33,11.9699441436678,"Q3"
"1089","1979",14094.8469732364,61788.2546485911,47,85,0.383854910032824,38,23.4135134187527,"Q2"
"1090","198",19755.080140475,61641.7840980305,52,122,0.1835542160552,70,57.151204876136,"Q1"
"1091","1980",14202.1869894307,61773.1631215946,89,135,0.497586219804361,46,23.1110338889994,"Q2"
"1092","1981",12248.9252739748,61823.2013043745,43,109,0.888192240614444,66,7.37931211944669,"Q4"
"1093","1982",12710.0893561928,61808.7347116861,54,125,0.687014241470024,71,22.2219888556283,"Q3"
"1094","1983",12417.0039053394,61817.136632227,49,104,0.726936554769054,55,15.018489487702,"Q3"
"1095","1984",12367.5787722228,61821.3435014519,58,124,0.861858983291313,66,9.11730710277334,"Q4"
"1096","1985",12569.107588118,61810.1457552783,48,110,0.646594013553113,62,21.911171159707,"Q3"
"1097","1986",12853.366595911,61799.0235054055,50,115,0.561849041841924,65,28.4798122802749,"Q3"
"1098","1987",12249.1090301598,61823.6020111999,62,109,0.876433161785826,47,5.80764139606617,"Q4"
"1099","1988",12466.287523115,61810.3836439563,48,90,0.528310280060396,42,19.8109682374634,"Q3"
"1100","1989",16900.0201424931,61718.1007075751,69,122,0.275377849815413,53,38.4049739597831,"Q1"
"1101","199",12376.1155049651,61818.690914481,61,99,0.692073164274916,38,11.7012197575532,"Q3"
"1102","1990",20993.627451035,61641.6307301885,50,117,0.0465154412668198,67,63.8834654351231,"Q1"
"1103","1991",17854.9426010446,61718.4557310843,77,122,0.0650928148534149,45,42.0708233315963,"Q1"
"1104","1992",20692.3690648022,61624.7115894807,60,128,0.0876456380356103,68,62.0400966135785,"Q1"
"1105","1993",12519.2445478529,61816.5242532836,53,123,0.783375577069819,70,15.1637096051127,"Q3"
"1106","1994",12090.182481867,61826.3224652736,68,109,0.990656546549872,41,0.383081591455266,"Q4"
"1107","1995",12299.4884405055,61820.0396012166,54,89,0.692702648229897,35,10.7554073119536,"Q4"
"1108","1996",13250.9697282068,61798.1535587761,65,108,0.504549542441964,43,21.3043696749955,"Q3"
"1109","1997",18554.527965622,61723.4138868842,52,101,0.0217194554861635,49,47.935746681178,"Q1"
"1110","1998",17064.0513740231,61730.2666478567,49,101,0.233415141003206,52,39.8624126678333,"Q1"
"1111","1999",12195.0436133028,61824.4030646472,60,97,0.877187967998907,37,4.54404518404044,"Q4"
"1112","2",13769.0718598959,61794.9172854973,62,94,0.375108074629679,32,19.9965416118503,"Q2"
"1113","20",12155.8550118445,61824.6832141854,50,82,0.866297801025212,32,4.27847036719322,"Q4"
"1114","200",17386.3186504442,61734.9293861854,53,100,0.129001281922683,47,40.9369397496339,"Q1"
"1115","2000",17729.6955436705,61675.423957998,50,127,0.365945565048605,77,48.8221914912574,"Q1"
"1116","2001",18718.0947487874,61695.7295860211,47,105,0.153160499641672,58,49.116691020783,"Q1"
"1117","2002",20063.4049991394,61665.8141838901,54,116,0.0636423777323216,62,58.0541725805961,"Q1"
"1118","2003",13253.5828381408,61802.5037380399,57,89,0.423185266088694,32,18.4580714851618,"Q3"
"1119","2004",16599.6929618087,61760.6539698285,53,91,0.0709210310596973,38,35.3050008197315,"Q2"
"1120","2005",12170.8367434036,61825.2878170664,59,106,0.928595300763845,47,3.35602086409926,"Q4"
"1121","2006",12184.1274838029,61823.7857395595,38,94,0.889896106207743,56,6.16581805236638,"Q4"
"1122","2007",12382.5915623506,61820.029086532,49,115,0.824588671326637,66,11.5771476924419,"Q4"
"1123","2008",12357.783967258,61820.7521000938,54,112,0.822926199762151,58,10.2702804137953,"Q4"
"1124","2009",12299.4135479874,61820.5644123432,48,95,0.769091274822131,47,10.8527100833599,"Q4"
"1125","201",18809.3686212533,61706.2044402651,46,100,0.095216202782467,54,48.8583250497468,"Q1"
"1126","2010",12873.4132371051,61802.1836793611,65,130,0.623200963716954,65,24.491937358398,"Q3"
"1127","2011",12266.0173376134,61823.0813616716,62,107,0.855332979233935,45,6.5100159344729,"Q4"
"1128","2012",12413.7463542743,61819.6864986574,53,120,0.82651382079348,67,11.6235740068369,"Q4"
"1129","2013",12529.9353571514,61816.7327943415,63,126,0.78263838076964,63,13.6937820115127,"Q3"
"1130","2014",17495.2185475544,61735.2177433379,49,96,0.122114731697366,47,41.2606076102238,"Q1"
"1131","2015",18954.3503409412,61651.2742601645,59,128,0.240035703405738,69,52.4375364650041,"Q1"
"1132","2016",12630.1862709249,61808.5248394418,60,109,0.579290812369436,49,20.6147501938976,"Q3"
"1133","2017",13641.9940887264,61795.010014151,50,87,0.407445229357108,37,21.924526513787,"Q2"
"1134","2018",12548.008015037,61812.2037673261,57,108,0.635063581867144,51,18.6117573247757,"Q3"
"1135","2019",14826.5973245754,61781.6549119575,39,72,0.355509820394218,33,21.2681759269908,"Q2"
"1136","202",12498.9782169146,61811.7068293675,50,102,0.61546139861457,52,19.9960072720423,"Q3"
"1137","2020",16113.4122563511,61725.725676989,56,123,0.409887752961367,67,39.5375205515884,"Q1"
"1138","2021",18473.4480036331,61727.4781680381,48,96,0.023075086530298,48,46.8923958465457,"Q1"
"1139","2022",16292.4278854654,61721.0120305583,69,129,0.383173663169146,60,37.0095802098513,"Q1"
"1140","2023",20247.6914585901,61640.4607134258,56,123,0.111351109109819,67,59.5394756896421,"Q1"
"1141","2024",14635.017994012,61782.9658864065,52,87,0.288778927875683,35,24.8927375243511,"Q2"
"1142","2025",14872.2838224517,61773.1783756267,45,89,0.374990465352312,44,27.5004195244983,"Q2"
"1143","2026",12372.4437061738,61821.313082977,68,126,0.856230940902606,58,8.33860542764887,"Q4"
"1144","2027",12235.7294490712,61824.2095840793,51,117,0.914696568623185,66,5.63002647086978,"Q4"
"1145","2028",13581.9976832245,61796.7745730225,53,88,0.402042713947594,35,20.9285050118342,"Q2"
"1146","2029",12150.4957729393,61825.1376806508,52,88,0.902094885706902,36,3.52458411455154,"Q4"
"1147","203",15965.6404531325,61759.5500712195,59,99,0.199930420378223,40,32.0027831848711,"Q2"
"1148","2030",12322.2558541812,61821.6699146797,67,109,0.811001795344055,42,7.9379245955497,"Q4"
"1149","2031",12425.5537643284,61817.5135217662,66,104,0.675919744418934,38,12.3150497120805,"Q3"
"1150","2032",12331.1534271131,61816.5723395692,52,85,0.568794318241999,33,14.229787498014,"Q3"
"1151","2033",12267.352191279,61820.2589813449,52,83,0.66401519626379,31,10.4155289158225,"Q4"
"1152","2034",12379.0859408005,61818.3651816756,66,98,0.648835227591917,32,11.2372727170587,"Q3"
"1153","2035",19641.3180164105,61627.1922696356,57,130,0.22156777838245,73,56.8255521780811,"Q1"
"1154","2036",15842.0708749262,61712.5850262594,74,149,0.492405873257667,75,38.069559505675,"Q1"
"1155","2037",14685.8345400578,61780.7794872179,56,92,0.297198829241097,36,25.3008421473205,"Q2"
"1156","2038",12102.9971979883,61826.3224652736,56,104,0.979538626270369,48,0.982145939022303,"Q4"
"1157","2039",16093.1916322229,61767.6361923686,52,88,0.10693024401553,36,32.1505112154409,"Q2"
"1158","204",12478.623847144,61815.9261183516,70,108,0.651352019282058,38,13.2486232672818,"Q3"
"1159","2040",12134.6684372081,61826.1812413188,59,111,0.961452167946845,52,2.00448726676404,"Q4"
"1160","2041",12262.4470807721,61822.8305346511,61,101,0.828799821203575,40,6.84800715185702,"Q4"
"1161","2042",12171.7584588572,61825.3225705961,66,109,0.929008769569919,43,3.0526229084935,"Q4"
"1162","2043",12480.9106732521,61815.7211804132,49,111,0.73240084759891,62,16.5911474488676,"Q3"
"1163","2044",16001.6384754637,61773.410736778,55,88,0.0541513042990118,33,31.2130069581326,"Q2"
"1164","2045",14303.8630826901,61779.5451714405,68,110,0.416654087137431,42,24.5005283402279,"Q2"
"1165","2046",12915.5804775911,61801.4650011379,61,136,0.654307673452422,75,25.9269244910683,"Q3"
"1166","2047",12130.7441985686,61825.7042768436,47,91,0.938264828873798,44,2.71634752955288,"Q4"
"1167","2048",12260.3973994151,61822.6538841938,49,101,0.846894676797092,52,7.96147680655122,"Q4"
"1168","2049",17170.5865879395,61700.1788820677,67,128,0.321230865549296,61,41.4049172014929,"Q1"
"1169","205",12491.6948184107,61818.2450711671,55,131,0.830688842572272,76,12.8676479645073,"Q3"
"1170","2050",12261.0307883394,61824.0777296005,61,128,0.919436885043979,67,5.39772870205343,"Q4"
"1171","2051",12174.2463290953,61824.9066981165,57,97,0.902717617573217,40,3.89129529707134,"Q4"
"1172","2052",20767.901242094,61603.1890281269,56,130,0.144851337885484,74,63.2810009964742,"Q1"
"1173","2053",12581.8687146486,61813.3366925831,56,118,0.709964121924713,62,17.9822244406678,"Q3"
"1174","2054",12764.2966422551,61804.2406820541,52,123,0.633472027489915,71,26.023486048216,"Q3"
"1175","2055",14205.8914665048,61780.5356356627,66,110,0.434049739968032,44,24.9018114414066,"Q2"
"1176","2056",15249.8964877155,61780.0122581299,51,83,0.159598739584908,32,26.8928403332829,"Q2"
"1177","2057",21237.9825244675,61655.7604996852,41,104,0.0158504683058709,63,62.0014204967301,"Q1"
"1178","2058",12118.1318896223,61825.6588708097,48,79,0.9215904250741,31,2.43069682270288,"Q4"
"1179","2059",12371.6253487328,61817.7634468178,59,94,0.637939356965944,35,12.672122506192,"Q3"
"1180","206",12292.3238858418,61820.4266722928,55,89,0.700364492367953,34,10.1876072594896,"Q4"
"1181","2060",20777.7652834197,61657.1482580881,50,114,0.0254757984075695,64,62.3695489019156,"Q1"
"1182","2061",13927.8059655604,61788.5163380409,67,105,0.420849313959479,38,22.0077260695398,"Q2"
"1183","2062",14001.2021816041,61790.9446018656,54,89,0.360457875300199,35,22.383974364493,"Q2"
"1184","2063",16665.3836956126,61705.083746929,64,132,0.397392286453396,68,40.9773245211691,"Q1"
"1185","2064",12329.5707833667,61822.0791487876,64,119,0.859047377016395,55,7.75239426409826,"Q4"
"1186","2065",12915.3407872805,61802.2714235599,63,138,0.667540186550468,75,24.9344860087149,"Q3"
"1187","2066",12236.5085868104,61825.1661423298,95,166,0.956617722287774,71,3.08014171756804,"Q4"
"1188","2067",15464.9164242818,61769.7299343061,58,95,0.217410537879914,37,28.9558100984432,"Q2"
"1189","2068",12364.5920767506,61821.2027649542,76,122,0.83046486438252,46,7.79861623840407,"Q4"
"1190","2069",16991.573749379,61703.2407474149,48,120,0.382287991698831,72,44.4752645976841,"Q1"
"1191","207",14726.5166427352,61754.7300113666,63,132,0.502273074816912,69,34.343157837633,"Q2"
"1192","2070",12892.2010022226,61800.0305110596,58,123,0.588840659009293,65,26.725357164396,"Q3"
"1193","2071",22354.1200516239,61509.1037938886,78,154,0.0582747699227184,76,71.5711174858734,"Q1"
"1194","2072",18765.8858067388,61693.7570440118,55,112,0.123782395618036,57,49.9444034497719,"Q1"
"1195","2073",15114.1341007552,61774.219920273,71,104,0.226490437518805,33,25.5258155618794,"Q2"
"1196","2074",12126.3078849755,61825.9582028275,57,96,0.948445659130812,39,2.01061929389834,"Q4"
"1197","2075",12472.1516374844,61815.3030104465,67,104,0.620164273073897,37,14.0539218962658,"Q3"
"1198","2076",12138.7975014273,61824.7146805154,44,77,0.873099218821153,33,4.18772577890195,"Q4"
"1199","2077",12456.6587124077,61818.6781202407,80,125,0.779904632130638,45,9.9042915541213,"Q3"
"1200","2078",12734.6421615505,61807.1437595254,68,115,0.580910447053611,47,19.6972089884803,"Q3"
"1201","2079",12800.3975324193,61806.1744018061,59,131,0.678048789966851,72,23.1804871223867,"Q3"
"1202","208",16157.8065796258,61763.6242616639,47,85,0.153343761572614,38,32.1729370602407,"Q2"
"1203","2080",16811.1522006916,61743.5247944443,59,103,0.156209197593853,44,37.1267953058705,"Q1"
"1204","2081",12602.1603348432,61809.4743521191,60,109,0.589792351936921,49,20.1001747550908,"Q3"
"1205","2082",12584.2219414633,61809.9681354119,56,97,0.536946718813851,41,18.9851845286321,"Q3"
"1206","2083",12176.2559562967,61823.7839908135,43,85,0.857040815521032,42,6.00428574811667,"Q4"
"1207","2084",12323.9007470139,61821.9601567023,50,117,0.866564483614638,67,8.94017959781922,"Q4"
"1208","2085",12909.6980973239,61802.7689755003,72,139,0.660435918020085,67,22.7507934926543,"Q3"
"1209","2086",12178.2391385601,61825.3949201656,51,114,0.941191588761285,63,3.70492990803905,"Q4"
"1210","2087",12194.7062384739,61823.633748333,51,85,0.821689055068418,34,6.06257212767377,"Q4"
"1211","2088",12618.633612516,61809.2104746667,55,112,0.622548784827814,57,21.5147192648146,"Q3"
"1212","2089",17325.003351822,61734.620229628,48,96,0.160462770378217,48,40.2977870218456,"Q1"
"1213","209",12246.8119283683,61823.9820705973,55,117,0.907059829682112,62,5.76229055970907,"Q4"
"1214","2090",12113.057986094,61826.3224652736,66,109,0.972734634531662,43,1.17241071513854,"Q4"
"1215","2091",18705.3344851586,61701.1553885441,58,112,0.0901314821094275,54,49.1328999660909,"Q1"
"1216","2092",12739.1520272998,61805.0912429081,56,107,0.551997704198584,51,22.8481170858722,"Q3"
"1217","2093",12144.6759080463,61826.3224652736,61,132,0.972487781662494,71,1.95336750196293,"Q4"
"1218","2094",12376.9856833401,61816.8781330575,54,93,0.634369212668389,39,14.2596007059328,"Q3"
"1219","2095",12355.1485637826,61819.8354511066,55,102,0.76039224723354,47,11.2615643800236,"Q4"
"1220","2096",14137.3169801999,61786.8237713952,57,95,0.377302595414221,38,23.6625013742596,"Q2"
"1221","2097",16318.453479975,61754.2284495578,49,92,0.201059793820605,43,34.354428865714,"Q2"
"1222","2098",20889.226348796,61597.3847989101,58,132,0.136780560715124,74,63.8782385070808,"Q1"
"1223","2099",17733.7071877308,61729.7175810276,53,101,0.103811571141705,48,43.0170445851982,"Q1"
"1224","21",18440.113487796,61692.80623105,57,115,0.169531816150993,58,48.1671546632424,"Q1"
"1225","210",12388.4952796788,61819.5023463956,60,108,0.767483004368842,48,11.1608157902956,"Q4"
"1226","2100",12330.6931526361,61821.5979024404,71,112,0.812096993904561,41,7.70402324991301,"Q4"
"1227","2101",12908.6923411071,61801.9477187526,71,129,0.607823981670663,58,22.7462090631016,"Q3"
"1228","2102",12121.4485267692,61825.9241118274,59,91,0.942238341551274,32,1.84837307035923,"Q4"
"1229","2103",12784.6840272847,61804.523409782,56,125,0.63756885449402,69,25.0077490399126,"Q3"
"1230","2104",12658.4292393532,61808.7442259689,58,116,0.631242904812098,58,21.3879115208983,"Q3"
"1231","2105",17454.5517265192,61706.5130010035,50,112,0.29072176408954,62,43.9752506264485,"Q1"
"1232","2106",20273.9039684808,61662.3450113917,56,118,0.0439882858190686,62,59.2727262792177,"Q1"
"1233","2107",17406.4342884722,61746.3190432248,56,98,0.0377301024273038,42,40.4153356980532,"Q1"
"1234","2108",18908.6724436037,61694.7819469772,56,112,0.0960720006842166,56,50.6199679616839,"Q1"
"1235","2109",15076.9805538284,61781.0133109949,54,86,0.184858359163627,32,26.0845325067639,"Q2"
"1236","211",12419.030849469,61818.5786773079,64,109,0.740189836826175,45,11.6914573428221,"Q3"
"1237","2110",15347.9088589975,61742.5975640575,61,127,0.456573555245996,66,35.8661453537643,"Q1"
"1238","2111",12195.5082594004,61823.6634392135,43,92,0.869674456771463,49,6.38595161819831,"Q4"
"1239","2112",12535.6484671697,61812.7874140097,60,93,0.525411589071155,33,15.6614175606519,"Q3"
"1240","2113",13953.2401746428,61784.4395078724,37,90,0.539958574343473,53,24.3821955597959,"Q2"
"1241","2114",12341.6453112565,61819.419236111,54,96,0.720643667969853,42,11.7329659452662,"Q4"
"1242","2115",13055.2267951399,61804.9019515061,58,91,0.454227162990719,33,18.0105036213063,"Q3"
"1243","2116",12390.2324413536,61819.3359079794,61,107,0.756121385609731,46,11.2184162619524,"Q4"
"1244","2117",12236.2402282927,61823.9056720771,64,109,0.883320301072672,45,5.25058645172976,"Q4"
"1245","2118",13422.0512553142,61792.3259438891,69,119,0.529119912534952,50,23.5440043732524,"Q2"
"1246","2119",12243.6118460008,61822.4965663261,50,92,0.809232644503936,42,8.01222893083468,"Q4"
"1247","212",18710.8411143588,61656.2195952397,67,132,0.232328727142885,65,49.8986327357125,"Q1"
"1248","2120",12371.891706387,61818.6778603326,47,103,0.760898934444413,56,13.3896596711129,"Q3"
"1249","2121",12272.9584804529,61823.465294786,52,120,0.901451822835952,68,6.70127604715526,"Q4"
"1250","2122",12270.9424783786,61823.3500231998,69,116,0.8771980216261,47,5.7716929835733,"Q4"
"1251","2123",12708.2698593866,61806.4765093258,59,118,0.612495732493699,59,22.8627517828718,"Q3"
"1252","2124",12411.7817216974,61816.0203355767,53,97,0.648818188812584,44,15.4519996922463,"Q3"
"1253","2125",18622.161697493,61679.6917686524,54,117,0.206094128778204,63,50.0160698869731,"Q1"
"1254","2126",19315.6458002999,61707.3279813717,46,99,0.0225693194661289,53,51.8038260682952,"Q1"
"1255","2127",20797.9231072272,61604.1617340468,60,132,0.124681654851884,72,63.0229208506644,"Q1"
"1256","2128",16653.1732308882,61750.2883050274,45,88,0.185592892114073,43,35.0195056390949,"Q2"
"1257","2129",21187.6431284845,61646.8370879971,48,114,0.0200704846065491,66,64.6753480159678,"Q1"
"1258","213",12519.8820324055,61816.8179888098,75,125,0.75703557417728,50,12.148221291136,"Q3"
"1259","2130",16815.8830817698,61709.8524516697,62,125,0.353992267511785,63,40.6984871467575,"Q1"
"1260","2131",14992.1939838039,61780.0538071624,61,93,0.207745487336069,32,25.3521444052458,"Q2"
"1261","2132",12984.8091711807,61805.9183884919,57,90,0.459361193468794,33,17.8410806155298,"Q3"
"1262","2133",15005.8909531222,61761.5980423116,52,107,0.409776072949171,55,32.4623159877956,"Q2"
"1263","2134",15902.9933447092,61740.1395683104,66,119,0.357845846097916,53,34.0341701568104,"Q1"
"1264","2135",15367.0978118805,61770.4173596472,45,84,0.283738987753168,39,27.9341794776265,"Q2"
"1265","2136",12982.1950896457,61804.7680782073,75,111,0.525995238684118,36,17.0641714073718,"Q3"
"1266","2137",16360.5307208096,61733.7968932709,57,112,0.321227263193578,55,37.3325005243532,"Q1"
"1267","2138",12694.6477340136,61807.4213731965,48,122,0.67181809572503,74,24.2854609163478,"Q3"
"1268","2139",15091.5415344911,61738.6463222809,70,144,0.516445761080831,74,35.7830136800185,"Q1"
"1269","214",14835.9237077536,61766.438699765,65,113,0.406104925321415,48,28.5069635845721,"Q2"
"1270","2140",17758.299237308,61682.1695895347,53,124,0.331719012465328,71,47.4479501149617,"Q1"
"1271","2141",15890.0123664922,61757.6169087505,62,103,0.228569200495258,41,31.6286627796944,"Q2"
"1272","2142",12455.2176929262,61816.3682102994,68,105,0.647040931042284,37,13.0594855514355,"Q3"
"1273","2143",14019.4369496277,61781.4833054638,51,103,0.453725231811404,52,28.406287945807,"Q2"
"1274","2144",18239.6647207365,61658.935215951,56,131,0.329559910809621,75,50.2830066892784,"Q1"
"1275","2145",12667.2780806608,61805.2883702928,51,113,0.593421835917979,62,25.2078461730853,"Q3"
"1276","2146",12310.5673939268,61822.1238269351,60,111,0.843479626812041,51,7.98253903258592,"Q4"
"1277","2147",15489.622041428,61742.2099527057,78,131,0.413539931643754,53,31.082383622881,"Q1"
"1278","2148",18340.139838614,61719.1989300119,71,117,0.0115262856706977,46,45.4697908591479,"Q1"
"1279","2149",14267.0747383778,61780.0314992931,66,109,0.422313945600763,43,24.8405003391672,"Q2"
"1280","215",13167.4783378889,61803.8602142382,63,94,0.441481157205999,31,17.314084126614,"Q3"
"1281","2150",14742.6872856469,61764.8624430901,62,116,0.440959732513875,54,30.1881744442508,"Q2"
"1282","2151",13244.325836991,61794.5576393199,51,104,0.502007943345234,53,26.3935790027026,"Q2"
"1283","2152",15511.7531176535,61763.1496650113,38,83,0.407809029798955,45,26.648593659047,"Q2"
"1284","2153",14695.5961930293,61776.7014804279,62,101,0.339534399099648,39,25.7581584351137,"Q2"
"1285","2154",12461.1007698569,61819.2128904989,62,131,0.838706967886537,69,11.1292192158289,"Q4"
"1286","2155",12110.127620121,61825.7273154504,42,77,0.932788369711488,35,2.3524070600979,"Q4"
"1287","2156",12204.3708067165,61824.4361978614,53,104,0.901885955128819,51,5.00381628843024,"Q4"
"1288","2157",12313.3062805013,61819.4086251086,55,89,0.666894544148818,34,11.3255854989402,"Q4"
"1289","2158",12316.3951513149,61819.5232797947,56,90,0.672976515488699,34,11.1187984733842,"Q4"
"1290","2159",12537.3774727283,61807.118821697,42,107,0.621588594047353,65,24.5967413869221,"Q3"
"1291","216",16621.6750284428,61731.6468731794,52,107,0.296178636373952,55,38.7101749994326,"Q1"
"1292","2160",12925.26906284,61799.5019578088,58,133,0.629005967173725,75,27.8245524619706,"Q3"
"1293","2161",18024.3737301025,61715.9106638708,58,109,0.120077469851822,51,44.8760490375571,"Q1"
"1294","2162",17473.2345221548,61723.5355245396,52,104,0.188962539192289,52,42.173947962001,"Q1"
"1295","2163",14647.1124279289,61777.441342297,62,101,0.344704251037911,39,25.5565342095215,"Q2"
"1296","2164",12281.7542610039,61821.9432057795,60,97,0.782732651336119,37,8.03889190056361,"Q4"
"1297","2165",12279.9172759899,61822.6464117418,54,107,0.854689468862489,53,7.70145815028809,"Q4"
"1298","2166",12310.8372490264,61821.3841143981,63,101,0.775599250104278,38,8.52722849603742,"Q4"
"1299","2167",12446.9225745612,61816.4713053218,54,105,0.703200478106737,51,15.1367756165564,"Q3"
"1300","2168",12417.0101069943,61816.9054458747,49,103,0.717533911345527,54,15.2531687873416,"Q3"
"1301","2169",12598.9320048754,61815.3712860208,63,136,0.798068464035168,73,14.7410021254327,"Q3"
"1302","217",17264.2742541271,61748.7837444829,49,91,0.0636516793165356,42,39.3266294687055,"Q2"
"1303","2170",12251.1869596646,61822.4995270858,60,92,0.775497433263808,32,7.18408213555813,"Q4"
"1304","2171",19896.8236379135,61669.7123037479,62,121,0.0435757248196751,59,56.4290322356392,"Q1"
"1305","2172",12173.0947446275,61824.7055288097,59,91,0.875451491912827,32,3.98555225878954,"Q4"
"1306","2173",12841.8923776716,61806.3010107655,63,139,0.709018475143239,76,22.1145958891138,"Q3"
"1307","2174",12189.5578673027,61824.5772113098,58,98,0.889961341628805,40,4.40154633484781,"Q4"
"1308","2175",18544.3627954494,61695.4141850351,46,105,0.18649872392416,59,47.9965752884746,"Q1"
"1309","2176",12256.3101223266,61822.7623648825,56,98,0.826335941208526,42,7.29389046924189,"Q4"
"1310","2177",12774.2701296216,61805.6804016094,53,127,0.665340579347685,74,24.7647971282713,"Q3"
"1311","2178",12680.4339711039,61807.6134812211,58,103,0.545521876774728,45,20.4515155451372,"Q3"
"1312","2179",12430.0427834695,61815.0985932573,55,97,0.619888692395762,42,15.964674919378,"Q3"
"1313","218",12517.9647416328,61815.8670344584,66,116,0.717089029029012,50,14.1455485485494,"Q3"
"1314","2180",12498.4409305584,61815.6629062864,71,111,0.664160270709544,40,13.4335891716182,"Q3"
"1315","2181",15612.7011753428,61774.3781865314,51,85,0.142017973121256,34,29.1713889138773,"Q2"
"1316","2182",12096.6842423284,61826.3224652736,65,97,0.978160038357601,32,0.698878772556782,"Q4"
"1317","2183",16018.7485414349,61773.1058979295,43,75,0.0927472722250968,32,29.0320872887969,"Q2"
"1318","2184",12249.5334909106,61823.3304877077,57,104,0.862239454174414,47,6.47474565380253,"Q4"
"1319","2185",15109.507739592,61746.4027839424,55,126,0.472611295059323,71,37.444598050788,"Q2"
"1320","2186",15082.0375453694,61769.66775127,57,99,0.319859216688201,42,28.5659128990956,"Q2"
"1321","2187",21840.3649536105,61601.3428044879,44,118,0.083660431439057,74,67.8091280735098,"Q1"
"1322","2188",19462.5726373403,61702.5175011264,45,99,0.029778404859826,54,52.3919661375694,"Q1"
"1323","2189",12520.9379642176,61816.6779648314,70,123,0.756563682109118,53,12.9021248482168,"Q3"
"1324","219",15846.7398508773,61719.9465158277,65,139,0.470258907414973,74,39.200840851292,"Q1"
"1325","2190",12222.4450695171,61821.9778127396,48,82,0.748553700977936,34,8.54917416675016,"Q4"
"1326","2191",12340.8849561968,61819.9405842176,59,98,0.728534855181351,39,10.5871406479273,"Q4"
"1327","2192",16689.9750645958,61754.9952562642,55,95,0.0985821052454412,40,36.0567157901824,"Q2"
"1328","2193",16660.1139828745,61729.0624699473,53,109,0.301492869853973,56,39.1163992881775,"Q1"
"1329","2194",16517.386972541,61763.6485487338,51,88,0.0639097653329372,37,34.6353386826813,"Q2"
"1330","2195",12606.7912538022,61811.9975440279,58,117,0.680925021180883,59,18.8254237503279,"Q3"
"1331","2196",15406.3436910604,61761.7636113603,54,100,0.322274756152183,46,31.1753612169996,"Q2"
"1332","2197",15578.6357016425,61763.6834306152,57,98,0.25662804977037,41,30.4782499594148,"Q2"
"1333","2198",14073.8684734332,61791.2530819327,63,94,0.327575722942129,31,20.845152588794,"Q2"
"1334","2199",12175.0357325448,61824.3343171879,51,86,0.858872915385291,35,4.93944796151482,"Q4"
"1335","22",12108.6523281441,61826.3224652736,59,133,0.987906674854457,74,0.894906060770154,"Q4"
"1336","220",12417.6830282467,61816.7197435018,67,99,0.607001688331366,32,12.5759459733963,"Q3"
"1337","2200",14158.5485400311,61773.4499459566,53,115,0.484343983698636,62,31.9706730106845,"Q2"
"1338","2201",15946.3823390112,61765.0341022704,53,91,0.164823805913329,38,31.7366953752935,"Q2"
"1339","2202",18258.7608368251,61704.4165048975,68,119,0.106441373005509,51,45.571489976719,"Q1"
"1340","2203",16460.6774373607,61733.7303172737,40,99,0.402409493923187,59,35.257839858532,"Q1"
"1341","2204",15781.3472987176,61749.1277249229,62,111,0.327810160117224,49,32.937302154256,"Q2"
"1342","2205",15479.2347672246,61768.9331490596,56,94,0.227513844845816,38,29.354473895859,"Q2"
"1343","2206",12153.6200443882,61822.8255801899,39,74,0.807216889224946,35,6.74740887712687,"Q4"
"1344","2207",12373.3561717,61819.9932223597,70,108,0.750353370793164,38,9.48657190985978,"Q4"
"1345","2208",14334.4872458911,61786.7599804119,61,94,0.31364176957868,33,22.6498216039035,"Q2"
"1346","2209",13251.2966714841,61801.0820894052,46,81,0.440540843410417,35,19.5810704806354,"Q3"
"1347","221",12281.5222993739,61821.5300335097,54,94,0.772828562185168,40,9.08685751259327,"Q4"
"1348","2210",12143.9490855929,61826.0709625468,77,120,0.957869911799207,43,1.81159379263408,"Q4"
"1349","2211",12338.4141537613,61818.3233719567,52,91,0.667004830669612,39,12.9868116038851,"Q3"
"1350","2212",16279.0095975026,61716.6141108094,78,136,0.385967456270009,58,35.6138875363395,"Q1"
"1351","2213",18001.51568034,61663.1939345252,69,137,0.315627494361252,68,46.5373303834349,"Q1"
"1352","2214",18636.5434843059,61674.2993211594,61,123,0.200976012274623,62,49.5394872389734,"Q1"
"1353","2215",17810.7886335507,61738.157459849,52,97,0.0416005714796484,45,43.1279742834158,"Q1"
"1354","2216",14892.7208136342,61769.2642539928,50,98,0.377476904075593,48,29.8811086043715,"Q2"
"1355","2217",12383.7102468421,61820.5801623665,78,121,0.807919648941606,43,8.25945509551093,"Q4"
"1356","2218",12523.7835328569,61815.4420970196,62,115,0.714870533905923,53,15.1118617029861,"Q3"
"1357","2219",16257.4907798193,61741.0389200591,69,115,0.26278301468119,46,33.9119813246652,"Q1"
"1358","222",12629.7470487871,61809.6131901057,65,113,0.600688440026715,48,19.1669548787177,"Q3"
"1359","2220",16217.7861669649,61724.9059707623,57,122,0.395798836369067,65,39.2730756360106,"Q1"
"1360","2221",12447.8469070833,61817.337094947,53,110,0.747179151279852,57,14.4107883770484,"Q3"
"1361","2222",12105.5032644267,61826.3224652736,53,125,0.987405984429643,72,0.906769121065736,"Q4"
"1362","2223",12086.119985854,61826.3224652736,51,87,0.988656289409846,36,0.408373581245542,"Q4"
"1363","2224",14903.9088809794,61783.0210789995,48,80,0.223405961412936,32,24.851009234786,"Q2"
"1364","2225",17599.0781687956,61706.067058207,57,115,0.24550878466107,58,43.760490489658,"Q1"
"1365","2226",12131.3298110661,61826.3224652736,62,131,0.97745273145847,69,1.55576152936555,"Q4"
"1366","2227",18590.2471545428,61710.3832564988,56,108,0.0700118865352124,52,48.359381900169,"Q1"
"1367","2228",12944.9499534389,61798.9775002261,58,120,0.571752137504518,62,26.5513674747199,"Q3"
"1368","2229",14712.0998743917,61770.0945677208,63,110,0.40512961987406,47,27.9589078659192,"Q2"
"1369","223",13722.9593180886,61788.4054710341,45,93,0.462877348531038,48,25.7818872705102,"Q2"
"1370","2230",12099.9082679285,61826.3224652736,46,97,0.978677532635629,51,1.08744583558291,"Q4"
"1371","2231",16668.7138685604,61730.2324187325,63,114,0.267039214493707,51,37.381000060821,"Q1"
"1372","2232",12500.2171306878,61817.8582854665,62,128,0.808617445640266,66,12.6312485877424,"Q3"
"1373","2233",20308.0833874732,61680.4466829411,45,104,0.0187870981171727,59,57.8915612110868,"Q1"
"1374","2234",19577.9677285672,61636.9120792018,60,129,0.192436586832628,69,55.7218755085487,"Q1"
"1375","2235",12283.5718070777,61821.9862012017,63,98,0.779466520762071,35,7.71867177332751,"Q4"
"1376","2236",12214.2057877158,61823.6893173205,58,93,0.837348437169567,35,5.69280469906516,"Q4"
"1377","2237",19558.4290279804,61684.9967177024,58,115,0.0442634914070368,57,54.4769809897989,"Q1"
"1378","2238",13726.4075819353,61792.9529338405,62,99,0.421433269279078,37,21.4069690366741,"Q2"
"1379","2239",12381.0306945289,61811.7299138916,42,92,0.60539736575447,50,19.7301317122765,"Q3"
"1380","224",13036.6308378062,61801.1052048492,64,110,0.531388599425554,46,21.5561244264245,"Q3"
"1381","2240",12666.5597266895,61810.2438268245,32,101,0.732914682477713,69,18.4288869090378,"Q3"
"1382","2241",12337.5803185272,61820.572444776,52,104,0.794960279483348,52,10.6620654668659,"Q4"
"1383","2242",12338.3987514087,61822.5747749463,63,136,0.901943795615807,73,7.15810292004608,"Q4"
"1384","2243",12190.393199727,61824.4270076855,57,95,0.877806812524796,38,4.64334112405777,"Q4"
"1385","2244",12331.8857425942,61818.6680960898,55,90,0.652567214332521,35,12.1601474983618,"Q3"
"1386","2245",12314.2298508533,61820.2520012883,48,97,0.769477717578411,49,11.2955918386579,"Q4"
"1387","2246",14998.540913736,61772.2004865843,65,103,0.301013296470046,38,26.5614947341383,"Q2"
"1388","2247",17188.6558730772,61703.0493923238,54,120,0.337018141290173,66,43.7568026748486,"Q1"
"1389","2248",12787.7728768068,61803.7906562654,51,100,0.523325441172346,49,23.357053382555,"Q3"
"1390","2249",12203.4050246926,61824.2989165028,67,100,0.868539849063382,33,4.33818498090841,"Q4"
"1391","225",12563.9690819033,61815.3946424878,83,129,0.732402732828632,46,12.3094742898829,"Q3"
"1392","2250",14913.7702270344,61778.401012945,58,93,0.259888690663502,35,25.9038958267774,"Q2"
"1393","2251",12672.8413470656,61810.044791656,72,110,0.5663962229155,38,16.476943529211,"Q3"
"1394","2252",12361.2167654706,61819.3268826072,64,99,0.696069609140977,35,10.6375636800658,"Q4"
"1395","2253",16114.0686620853,61766.8158551878,39,73,0.173740802099928,34,28.0928127286024,"Q2"
"1396","2254",12503.4845687977,61813.37983394,55,86,0.504203446442261,31,15.3696931602899,"Q3"
"1397","2255",14124.9121808459,61785.6470255093,74,109,0.390019429149106,35,21.3493199797813,"Q2"
"1398","2256",20673.5517029957,61662.260247206,50,113,0.0211273422464728,63,61.6689774384722,"Q1"
"1399","2257",15241.2303630195,61771.461712466,53,92,0.266642292728648,39,28.6009505835827,"Q2"
"1400","2258",12260.4750814792,61823.5923303938,61,115,0.889833363238722,54,5.94899838510901,"Q4"
"1401","2259",12420.8330030994,61818.8834375798,65,112,0.759693501051515,47,11.2944054505788,"Q3"
"1402","226",12391.8766943514,61815.0188031382,54,91,0.573881329735741,37,15.7663907997776,"Q3"
"1403","2260",18471.1379660125,61686.5449608035,65,122,0.163720080861822,57,47.6679553908762,"Q1"
"1404","2261",12346.9530559992,61821.0005077513,70,110,0.788945106323808,40,8.44219574704766,"Q4"
"1405","2262",19200.1132631537,61670.5492330953,51,115,0.168188500683755,64,53.2359359562397,"Q1"
"1406","2263",12336.5921276248,61820.9443044414,53,107,0.812840015394613,54,10.1066391686909,"Q4"
"1407","2264",17318.5418883347,61683.0702540516,59,133,0.382431478705257,74,45.700070575811,"Q1"
"1408","2265",16073.3670828285,61755.8582988242,61,102,0.204556138953194,41,32.613198302919,"Q2"
"1409","2266",14753.6351266709,61782.5707446409,51,85,0.262833929853514,34,25.0636463849805,"Q2"
"1410","2267",17541.8703574594,61723.2575869128,42,94,0.234192700823769,52,39.821979557164,"Q1"
"1411","2268",15448.0936100971,61758.0655642213,47,98,0.364981062244624,51,32.3859658255242,"Q2"
"1412","2269",12162.4204324745,61824.889510358,51,90,0.895825682906434,39,4.06279836664908,"Q4"
"1413","227",15770.4189286033,61728.5097448801,55,128,0.449655693955719,73,40.1751343412325,"Q1"
"1414","2270",17967.1245296657,61731.2342221142,58,104,0.0429413544479758,46,44.0246976953931,"Q1"
"1415","2271",16383.6598246932,61771.0660272359,50,84,0.016533121233806,34,33.4378738780506,"Q2"
"1416","2272",12313.7030839271,61815.6043650647,42,88,0.650392852257937,46,16.0819287961349,"Q3"
"1417","2273",18393.575480397,61661.5405232951,50,125,0.318237061146647,75,51.1322204140015,"Q1"
"1418","2274",12225.3622230566,61823.6522237791,57,98,0.855816539842635,41,5.91152186645195,"Q4"
"1419","2275",12149.6161952973,61826.3224652736,62,128,0.967491205316037,66,2.14558044914156,"Q4"
"1420","2276",12971.293173347,61797.9235922399,60,129,0.600011889124289,69,27.599179650424,"Q3"
"1421","2277",14922.1646551522,61775.4568587316,44,84,0.349936458747834,40,26.0025416500866,"Q2"
"1422","2278",12121.8559733659,61826.3224652736,79,116,0.966861225897446,37,1.22613464179449,"Q4"
"1423","2279",12273.5029785551,61820.1531450265,52,84,0.668841423932463,32,10.5970744341612,"Q4"
"1424","228",16928.030701177,61754.2977726554,74,110,0.00113658560439944,36,35.9590829182416,"Q2"
"1425","2280",17884.8693917295,61711.5067254292,80,126,0.083554029930383,46,42.1565146232024,"Q1"
"1426","2281",12402.0171410856,61818.2926817538,50,106,0.756399932783097,56,13.6416037641466,"Q3"
"1427","2282",16303.7110143042,61729.3684459612,64,120,0.345157842850313,56,36.6711608003825,"Q1"
"1428","2283",12259.3152550897,61824.3561890874,71,138,0.931026292964816,67,4.62123837135732,"Q4"
"1429","2284",13113.8881812471,61800.3702927308,52,95,0.480857524788007,43,22.3231264341157,"Q3"
"1430","2285",17374.3841668149,61699.6449049845,55,120,0.318851283052936,65,44.2746666015591,"Q1"
"1431","2286",12086.8760444104,61826.3224652736,77,110,0.992519059916958,33,0.246871022740379,"Q4"
"1432","2287",15868.7465391482,61752.9961658176,52,100,0.298171851085499,48,33.6877511478961,"Q2"
"1433","2288",12279.7978331573,61822.257001961,52,102,0.832705682842061,50,8.36471585789695,"Q4"
"1434","2289",13861.1815967795,61786.081006142,60,107,0.46257472387515,47,25.2589879778679,"Q2"
"1435","229",12107.4214060955,61826.3224652736,63,125,0.985796329099685,62,0.880627595819533,"Q4"
"1436","2290",12309.8758662094,61819.4533162378,53,89,0.679493081057444,36,11.538249081932,"Q4"
"1437","2291",12873.5930497553,61805.6318769904,94,133,0.606035016011447,39,15.3646343755536,"Q3"
"1438","2292",12373.9244961333,61821.0539732921,51,124,0.862770243315026,73,10.0177722380031,"Q4"
"1439","2293",15782.4489200281,61768.008299498,71,104,0.119231469463557,33,29.0653615077026,"Q2"
"1440","2294",18666.6415414263,61675.8635761042,64,124,0.179818891687319,60,49.2108664987609,"Q1"
"1441","2295",12204.1865423611,61823.176578959,45,88,0.835772508522496,43,7.06178213353269,"Q4"
"1442","2296",17701.9121180318,61723.5183097367,51,102,0.153214835794643,51,43.1860433744732,"Q1"
"1443","2297",19056.8903196391,61692.0915076708,61,116,0.0705326043535024,55,51.1207067605574,"Q1"
"1444","2298",16661.0342675598,61747.1067564479,66,107,0.136482065077871,41,35.4042353318073,"Q2"
"1445","2299",18102.6074353305,61725.4863260198,73,117,0.00543732522055507,44,43.7607576902956,"Q1"
"1446","23",12258.0339315389,61821.8611615779,52,90,0.770506544271484,38,8.72075131768361,"Q4"
"1447","230",16714.0677809344,61715.2923749561,56,120,0.357701933942735,64,41.1070762276649,"Q1"
"1448","2300",18203.190624991,61726.4929299006,59,106,0.0325022100005299,47,45.4723961299751,"Q1"
"1449","2301",12108.3864730265,61826.3224652736,58,97,0.967481568688527,39,1.26821882114746,"Q4"
"1450","2302",14092.3337415058,61778.609870164,70,120,0.484331270912662,50,25.7834364543669,"Q2"
"1451","2303",12314.4088833203,61816.246413423,41,90,0.682338746264577,49,15.5654014330357,"Q3"
"1452","2304",12618.7850717866,61810.3528579938,58,114,0.640987855847925,56,20.1046800725162,"Q3"
"1453","2305",12442.2850374532,61820.1265786184,69,142,0.873010982526466,73,9.27019827556796,"Q4"
"1454","2306",17191.4051595188,61673.0366826812,78,147,0.392498886911198,69,41.9175768031273,"Q1"
"1455","2307",15837.5743410287,61741.9771011572,61,116,0.368224980542436,55,34.747626070166,"Q1"
"1456","2308",12452.763005389,61817.8818045473,56,114,0.768011171370745,58,13.4553520604968,"Q3"
"1457","2309",12651.5450493515,61810.4483210815,63,119,0.657253255369142,56,19.1938176993281,"Q3"
"1458","231",13082.2497622462,61802.6227067855,68,106,0.50575221516192,38,18.7814158238471,"Q3"
"1459","2310",16472.8695254281,61747.8278904762,49,95,0.223117285175249,46,35.7366048819385,"Q2"
"1460","2311",16332.0810572074,61760.6610719849,57,95,0.113190132658929,38,33.6987749589607,"Q2"
"1461","2312",12451.3846942855,61816.3536201558,65,104,0.653507487149909,39,13.5132080011535,"Q3"
"1462","2313",12462.9160751523,61813.6143650285,59,98,0.57691644388251,39,16.5002586885821,"Q3"
"1463","2314",16613.8923524657,61757.6519729302,55,94,0.0899240043945611,39,35.4929638286121,"Q2"
"1464","2315",12110.6111971848,61826.2808010496,61,97,0.96390566136688,36,1.29939619079232,"Q4"
"1465","2316",13549.0149479982,61785.5969475193,47,107,0.495074041187763,60,30.2955575287342,"Q2"
"1466","2317",12275.0412163469,61819.2422580613,50,82,0.63513226644136,32,11.6757674738765,"Q4"
"1467","2318",17166.5643892211,61749.3277244301,57,98,0.0524098637979478,41,38.8511955842841,"Q2"
"1468","2319",12539.9635761436,61811.1817946329,47,80,0.487124746199697,33,16.92488337541,"Q3"
"1469","232",16694.2799729317,61753.5534351941,53,94,0.115961194969714,41,36.2455910062417,"Q2"
"1470","2320",12643.1023366649,61811.7012415838,36,68,0.621231678174809,32,12.1205862984061,"Q3"
"1471","2321",12755.5578952261,61804.4590342088,58,120,0.605474381241947,62,24.4605883629993,"Q3"
"1472","2322",12444.3909499797,61819.6646796467,59,131,0.848516025813296,72,10.9068461414427,"Q4"
"1473","2323",15264.0053037502,61765.4659516998,52,97,0.325136375846341,45,30.3688630869146,"Q2"
"1474","2324",20785.1879279736,61637.9945152358,67,130,0.0189268537797034,63,61.8076082118787,"Q1"
"1475","2325",12284.8566490779,61822.2573197348,55,103,0.830282674869522,48,8.14643160626292,"Q4"
"1476","2326",14661.0107516012,61776.7908098786,75,110,0.32634410308674,35,23.5779563919641,"Q2"
"1477","2327",12864.3729240511,61803.7613377,62,134,0.663452115375549,72,24.2314476929605,"Q3"
"1478","2328",20728.1218437718,61625.2998916726,65,131,0.0640530628152192,66,61.7724978541955,"Q1"
"1479","2329",20604.9826639228,61641.8941880521,59,124,0.0562615587841719,65,61.3429986790288,"Q1"
"1480","233",13471.9371425126,61796.3086245549,41,81,0.494495784165338,40,20.2201686333865,"Q2"
"1481","2330",12601.7291353785,61809.76555539,59,110,0.60419785301201,51,20.1859094963875,"Q3"
"1482","2331",12122.1642522396,61825.8191141485,55,87,0.934682980179787,32,2.09014463424683,"Q4"
"1483","2332",12611.870009112,61811.2060867111,62,97,0.52911486546509,35,16.4809797087219,"Q3"
"1484","2333",16895.0703102061,61705.6527589554,50,121,0.380457543302327,71,43.9875144255348,"Q1"
"1485","2334",12356.5973495677,61818.0711044629,61,92,0.615284707630053,31,11.9261740634684,"Q3"
"1486","2335",16564.0416742723,61753.3348286002,50,92,0.15349857811816,42,35.5530597190373,"Q2"
"1487","2336",12083.4550405139,61826.3224652736,59,112,0.996801622211933,53,0.169514022767544,"Q4"
"1488","2337",14370.7953415112,61784.8040193788,57,93,0.334650932345539,36,23.9525664355606,"Q2"
"1489","2338",15561.8907493637,61767.3398115104,41,80,0.307689475361258,39,27.0001104609109,"Q2"
"1490","2339",21747.1065085649,61548.7221654354,66,143,0.10795395844616,77,68.6875451996457,"Q1"
"1491","234",12297.5564016842,61822.1189484052,56,106,0.834366346942261,50,8.28168265288696,"Q4"
"1492","2340",19943.0029350579,61625.8532282878,67,134,0.14845332223922,67,57.0536274099723,"Q1"
"1493","2341",14210.3138888007,61790.224344239,59,90,0.300564994802698,31,21.6824851611163,"Q2"
"1494","2342",12494.7172219686,61814.6967221747,52,108,0.692303495947272,56,17.2310042269528,"Q3"
"1495","2343",12206.7638432269,61823.8494803981,46,97,0.879360197111964,51,6.15262994728982,"Q4"
"1496","2344",12357.6088441847,61817.7104014577,54,92,0.647607556777075,38,13.3909128424712,"Q3"
"1497","2345",12172.6572687076,61825.4839148832,52,113,0.942711955867708,61,3.49457069206983,"Q4"
"1498","2346",16519.9585701607,61731.4625611484,65,116,0.284267084207386,51,36.5023787054233,"Q1"
"1499","2347",12306.0318950955,61819.3324468312,52,88,0.673842424759641,36,11.7416727086529,"Q4"
"1500","2348",20752.4748427752,61662.1037528509,46,109,0.0279229448642582,63,61.2408544735517,"Q1"
"1501","2349",16970.0555123455,61728.4745907934,49,103,0.262275935383514,54,39.8370994892903,"Q1"
"1502","235",15438.2711117358,61771.8139215325,51,88,0.217646179720759,37,28.9470913503319,"Q2"
"1503","2350",15882.9298327887,61770.8854477611,51,86,0.120247596642002,35,30.7913341175299,"Q2"
"1504","2351",12987.9209155913,61805.8783780665,73,105,0.497495630988851,32,16.0801398083568,"Q3"
"1505","2352",16040.9069749962,61730.1055273198,57,121,0.401093458291143,64,38.3300186693668,"Q1"
"1506","2353",12245.73902004,61824.0463251459,63,118,0.904930298449472,55,5.22883358527906,"Q4"
"1507","2354",15439.4704756057,61768.6020371224,62,99,0.227590532740578,37,28.5791502885986,"Q2"
"1508","2355",16785.4621039385,61690.9357229729,71,142,0.41830848203972,71,41.3000977751799,"Q1"
"1509","2356",19460.6993915677,61670.2817691678,51,114,0.133877674117684,63,54.5657065305859,"Q1"
"1510","2357",14581.9682569976,61777.4923916824,46,90,0.389379258966073,44,26.8673126054928,"Q2"
"1511","2358",14017.4234503588,61789.8692410142,48,85,0.378625060198829,37,22.9908727726433,"Q2"
"1512","2359",12079.0926557489,61826.3224652736,45,90,0.999492605915293,45,0.0228327338118106,"Q4"
"1513","236",12503.7125787241,61809.467803004,46,102,0.601690897485241,56,22.3053097408265,"Q3"
"1514","2360",13924.0747143668,61779.9836029385,61,118,0.500456619542092,57,28.4739726861008,"Q2"
"1515","2361",12471.5213902137,61812.7446719843,56,98,0.576515833847225,42,17.7863349784166,"Q3"
"1516","2362",17721.935310482,61704.1228183329,64,119,0.211521598277614,55,43.3663120947313,"Q1"
"1517","2363",12551.1387777803,61812.4364070504,51,111,0.674534183461219,60,19.5279489923269,"Q3"
"1518","2364",18912.0636291711,61709.3538679799,64,114,0.00608068751171231,50,49.6959656244144,"Q1"
"1519","2365",15482.2076406339,61733.1888417393,80,141,0.465078740147874,61,32.6301968509797,"Q1"
"1520","2366",14117.3675454231,61785.0274417846,55,97,0.404163454892114,42,25.0251348945312,"Q2"
"1521","2367",12250.6055922199,61823.2689373609,61,103,0.850750174373388,42,6.26849267631769,"Q4"
"1522","2368",13745.5025164719,61790.7328881473,57,99,0.438921050401405,42,23.565315883141,"Q2"
"1523","2369",14184.6384409868,61791.145941513,55,86,0.297177794622257,31,21.78748836671,"Q2"
"1524","237",14964.8054147813,61768.7027060089,71,111,0.339294848963618,40,26.4282060414553,"Q2"
"1525","2370",12284.0509588927,61821.146285079,53,92,0.753052164334804,39,9.63096559094265,"Q4"
"1526","2371",21977.6679469603,61604.3366677364,58,129,0.011069672415033,71,70.2140532585327,"Q1"
"1527","2372",21074.372241936,61612.4267698711,76,140,0.0141877189744264,64,63.0919859856367,"Q1"
"1528","2373",19724.7584504526,61619.8755397675,72,139,0.172561348881572,67,55.4383896249346,"Q1"
"1529","2374",13681.6591166725,61793.3699665779,54,93,0.420597318792716,39,22.5967045670841,"Q2"
"1530","2375",12153.2871380447,61825.870178584,63,114,0.951871991390362,51,2.45452843909152,"Q4"
"1531","2376",12303.9401562347,61820.9390611457,54,96,0.764367011608556,42,9.89658551244065,"Q4"
"1532","2377",12161.133725924,61825.0160418933,52,92,0.904070954537019,40,3.83716181851923,"Q4"
"1533","2378",17103.276801512,61722.7049935513,56,110,0.248113827314228,54,40.6018533250317,"Q1"
"1534","2379",15957.4418024758,61775.2150654334,63,94,0.0216630939394236,31,30.3284440878779,"Q2"
"1535","238",17083.7396985368,61738.7917388662,59,104,0.13860015803948,45,38.7629928882234,"Q1"
"1536","2380",12281.4933800061,61822.1282314809,61,99,0.796091156080365,38,7.74853606894612,"Q4"
"1537","2381",16238.6887428919,61770.5244339648,55,89,0.0376546534243971,34,32.7197417835705,"Q2"
"1538","2382",18238.0360965028,61723.3158167118,71,116,0.00483755441382527,45,44.7823100513779,"Q1"
"1539","2383",12742.9777526742,61806.3953098195,57,123,0.644676920492202,66,23.4513232475147,"Q3"
"1540","2384",12439.4639859402,61819.1476974567,62,121,0.807619754690677,59,11.3504344732501,"Q4"
"1541","2385",15735.0519411021,61776.6672904118,54,86,0.0760595516767353,32,29.5660943463445,"Q2"
"1542","2386",14853.0785533763,61781.4591678246,51,85,0.250069907167926,34,25.4976231562905,"Q2"
"1543","2387",12572.8804634835,61812.3108658783,59,112,0.654914537677541,53,18.2895295030903,"Q3"
"1544","2388",17068.5675304336,61700.1394547779,61,127,0.354808748699725,66,42.5826225858182,"Q1"
"1545","2389",12531.5284788191,61817.1742082488,69,132,0.802278493531048,63,12.456454907544,"Q3"
"1546","239",20280.2077506146,61644.3793064242,56,122,0.0964391964953393,66,59.6350130313076,"Q1"
"1547","2390",15571.8473333977,61749.1010416044,52,109,0.385040649678558,57,35.0526829683222,"Q2"
"1548","2391",12600.90527059,61808.391594509,50,110,0.616405874025077,60,23.0156475584954,"Q3"
"1549","2392",12489.7930546404,61815.494999821,64,108,0.668332291767001,44,14.5933791622519,"Q3"
"1550","2393",19676.5703866497,61616.5513841906,59,134,0.237760547781363,75,57.1679589163978,"Q1"
"1551","2394",12163.055965441,61824.9145065629,51,91,0.898989821784198,40,4.04040712863207,"Q4"
"1552","2395",12214.512469822,61824.0477582288,60,100,0.871278990991414,40,5.14884036034346,"Q4"
"1553","2396",12372.2589429877,61819.7275477439,61,105,0.755672528874129,44,10.7504087295383,"Q4"
"1554","2397",16627.6805848643,61745.2156192268,42,88,0.258891943609342,46,34.0909705939703,"Q1"
"1555","2398",12203.6235311392,61820.5965726462,42,77,0.715718793217093,35,9.94984223740175,"Q4"
"1556","2399",14361.7861588915,61774.3785941123,39,97,0.510384238790721,58,28.3977141501382,"Q2"
"1557","24",12399.1523075361,61819.0440174625,53,109,0.777288319077343,56,12.4718541316688,"Q4"
"1558","240",17890.8519978848,61730.0341315509,60,106,0.0553878743667156,46,43.4521577791311,"Q1"
"1559","2400",13330.676372775,61793.5786440317,53,105,0.498900453327224,52,26.0571764269844,"Q2"
"1560","2401",18013.5217988183,61675.6404868691,57,126,0.30559686338529,69,47.913816426415,"Q1"
"1561","2402",12462.0365861195,61818.471774344,57,122,0.805922035360709,65,12.6150677015539,"Q3"
"1562","2403",12106.2975338962,61826.3224652736,57,98,0.971189895179123,41,1.18121429765597,"Q4"
"1563","2404",12352.5682248797,61819.613040387,54,100,0.74775614682585,46,11.6032172460109,"Q4"
"1564","2405",12474.1928204762,61815.267261033,56,105,0.673307268880308,49,16.0079438248649,"Q3"
"1565","2406",17873.5451103691,61702.3947599548,50,110,0.240922981873155,60,45.5446210876107,"Q1"
"1566","2407",14659.1615772726,61779.0726132469,54,93,0.329184456262738,39,26.1618062057532,"Q2"
"1567","2408",14043.5839979193,61780.0051596839,50,104,0.458225287264213,54,29.2558344877325,"Q2"
"1568","2409",12264.1503717143,61823.4175414533,61,113,0.881261082366109,52,6.17442371696234,"Q4"
"1569","241",15497.4532854489,61761.4993866803,71,110,0.265369304688647,39,28.6505971171428,"Q2"
"1570","2410",13030.9507206023,61805.2678899198,48,80,0.436207676539198,32,18.0413543507457,"Q3"
"1571","2411",15840.8693017046,61735.4130514469,67,125,0.399008624255657,58,34.8574997931719,"Q1"
"1572","2412",17572.6114020014,61722.3499998192,62,111,0.146330933086574,49,41.8297842787579,"Q1"
"1573","2413",12272.8582706239,61822.8422283037,60,106,0.848350202431902,46,6.97589068813249,"Q4"
"1574","2414",12377.8018098981,61813.2793159501,49,88,0.546066009672359,39,17.703425622778,"Q3"
"1575","2415",15998.2883200226,61739.1629538839,58,114,0.357913448708132,56,35.9568468723446,"Q1"
"1576","2416",17132.4724807243,61694.251410635,50,125,0.386851192917675,75,45.9861605311744,"Q1"
"1577","2417",12317.0072461746,61821.0653145331,60,100,0.769944557687268,40,9.20221769250929,"Q4"
"1578","2418",13276.8378790589,61800.5704562781,57,93,0.446524200029671,36,19.9251287989318,"Q3"
"1579","2419",12228.0874376726,61822.7614348352,55,87,0.777114797849208,32,7.13232646882534,"Q4"
"1580","242",14717.3963000464,61758.5179614413,54,121,0.475575833581388,67,35.136419150047,"Q2"
"1581","2420",14318.577282839,61773.3610432522,49,106,0.453156203497201,57,31.1700964006595,"Q2"
"1582","2421",12343.6954763401,61817.3276935938,55,88,0.596314916620031,33,13.321607751539,"Q3"
"1583","2422",12146.4097089713,61824.9918050545,51,82,0.881202928721905,31,3.68270920962095,"Q4"
"1584","2423",13181.9522945851,61786.451271162,44,118,0.535738184349611,74,34.3553743581288,"Q2"
"1585","2424",19109.7890873382,61657.7885851867,72,132,0.14726558723487,60,51.1640647659078,"Q1"
"1586","2425",12784.8385351377,61805.9589884451,58,128,0.663280464475974,70,23.5703674866818,"Q3"
"1587","2426",14557.3025498872,61771.2047071437,62,112,0.432762240990996,50,28.3618879504502,"Q2"
"1588","2427",12093.1093149742,61826.3224652736,52,84,0.97443919070065,32,0.817945897579193,"Q4"
"1589","2428",12534.2330731128,61816.3526747718,61,124,0.772255866555497,63,14.3478804070037,"Q3"
"1590","2429",17701.8026670538,61697.4506918736,51,115,0.28721261699684,64,45.6183925122023,"Q1"
"1591","243",12080.6786470244,61826.3224652736,66,104,0.998149258550256,38,0.0703281750902534,"Q4"
"1592","2430",12095.7911070506,61826.3224652736,58,112,0.988538403529674,54,0.618926209397614,"Q4"
"1593","2431",12413.741425966,61817.0003096627,45,106,0.746704303659499,61,15.4510374767706,"Q3"
"1594","2432",16516.9849053352,61767.6702746444,47,82,0.0353348762728274,35,33.763279330451,"Q2"
"1595","2433",14838.10731673,61772.3239641624,58,101,0.354025754611939,43,27.7768925516866,"Q2"
"1596","2434",15178.9114810621,61769.282520858,66,104,0.281639796914533,38,27.2976877172478,"Q2"
"1597","2435",15299.5731245403,61772.0375109651,52,90,0.247613792540506,38,28.5906758834608,"Q2"
"1598","2436",12138.1372331272,61825.4973263146,56,89,0.917857612017542,33,2.71069880342111,"Q4"
"1599","2437",13229.4254878933,61801.6424925432,51,86,0.433234470896423,35,19.8367935186252,"Q3"
"1600","2438",15958.660219691,61732.9106376341,63,123,0.395358314272016,60,36.278501143679,"Q1"
"1601","2439",12580.4364543572,61814.697415009,66,124,0.7374489500653,58,15.2279608962126,"Q3"
"1602","244",13067.4007322,61803.329091528,56,93,0.469306088984013,37,19.6356747075915,"Q3"
"1603","2440",16106.1932955665,61768.415480605,45,80,0.120995986741036,35,30.7651404640637,"Q2"
"1604","2441",13513.9088530464,61797.9312469529,72,103,0.421963396249339,31,17.9191347162705,"Q3"
"1605","2442",20043.4787292191,61666.125111205,48,111,0.0868138012010604,63,57.5307305243332,"Q1"
"1606","2443",16974.1275823864,61714.7318705443,50,113,0.331014998955652,63,42.1460550657939,"Q1"
"1607","2444",13316.2658793453,61798.7068622151,67,105,0.480151807423681,38,19.7542313179001,"Q3"
"1608","2445",12319.4587403764,61820.4720170336,58,96,0.735928416252136,38,10.0347201824188,"Q4"
"1609","2446",12563.7577760833,61808.4644274049,49,106,0.597676975652575,57,22.9324123878032,"Q3"
"1610","2447",15321.669064259,61746.3317671038,49,116,0.440083991037682,67,37.5143726004753,"Q1"
"1611","2448",12716.8616572802,61805.0548019118,56,111,0.569925893796608,55,23.6540758411866,"Q3"
"1612","2449",12324.137237143,61821.9041485327,46,119,0.873841086169705,73,9.20960070961155,"Q4"
"1613","245",12135.0890776077,61825.6678125938,61,93,0.928417479852214,32,2.29064064472914,"Q4"
"1614","2450",12607.0385542455,61813.8138917268,63,125,0.734842343721539,62,16.4397746892646,"Q3"
"1615","2451",12745.4889747442,61807.8072017135,54,92,0.499611415667459,38,19.0147662046365,"Q3"
"1616","2452",15886.9486893837,61756.9868395564,40,85,0.348254786105826,45,29.3285346252378,"Q2"
"1617","2453",17204.5796480384,61712.0232105481,49,111,0.310393228195608,62,42.7556198518723,"Q1"
"1618","2454",17920.6673032714,61696.2173264401,95,140,0.0775830787606537,45,41.5087614557706,"Q1"
"1619","2455",12187.3599285659,61824.2085268098,44,95,0.891100202454254,51,5.55388967483304,"Q4"
"1620","2456",15163.4084097881,61762.6999736804,41,94,0.44134327583015,53,29.6088063810021,"Q2"
"1621","2457",12893.4132576925,61806.9153601982,57,91,0.474729289067909,34,17.8592041716911,"Q3"
"1622","2458",12745.4986398356,61810.9372029508,79,153,0.792051888303831,74,15.3881602655165,"Q3"
"1623","2459",12173.2416131104,61825.1349329533,60,103,0.918777971528471,43,3.49254722427577,"Q4"
"1624","246",16760.2723512957,61736.4293294985,62,109,0.209368605632335,47,37.1596755352803,"Q1"
"1625","2460",15366.0687493369,61746.2069576317,55,119,0.435091193998232,64,36.1541635841131,"Q1"
"1626","2461",12224.937636916,61823.7329533329,63,99,0.850080877542496,36,5.39708840847015,"Q4"
"1627","2462",12494.2209099071,61815.2282406186,75,109,0.617120974231511,34,13.0178868761286,"Q3"
"1628","2463",12211.6887150171,61823.8281102426,49,97,0.873204588424414,48,6.08617975562811,"Q4"
"1629","2464",13359.2475666378,61784.7970750905,45,114,0.518467224668711,69,33.2257614978589,"Q2"
"1630","2465",19316.9830768782,61651.0796001353,51,121,0.217865657527,70,54.74940397311,"Q1"
"1631","2466",12647.4902069416,61809.6648603606,50,85,0.487593096680939,35,17.9342416161671,"Q3"
"1632","2467",17251.580656181,61727.5130666435,63,111,0.169688177295029,48,39.8549674898386,"Q1"
"1633","2468",12094.6548900656,61826.3224652736,74,110,0.986206316389143,36,0.496572609990835,"Q4"
"1634","2469",12689.0491990467,61806.3546468051,54,102,0.540719725424424,48,22.0454531796277,"Q3"
"1635","247",14478.3598246258,61780.5311053238,52,93,0.362109267152846,41,26.1535200467333,"Q2"
"1636","2470",12333.6799130761,61821.7357754179,59,115,0.84680502046831,56,8.57891885377467,"Q4"
"1637","2471",12242.4935550109,61824.3580724381,72,127,0.919214689871296,55,4.4431920570787,"Q4"
"1638","2472",20958.0767664036,61646.1751849725,32,96,0.10034368140623,64,57.5780043900013,"Q1"
"1639","2473",17386.4574301147,61690.8856025219,59,127,0.34353708056733,68,44.6394785214216,"Q1"
"1640","2474",12370.7809903293,61817.6832043993,56,94,0.651976990513504,38,13.2248743604869,"Q3"
"1641","2475",15972.9870958433,61773.2286940194,46,79,0.0888472183141857,33,30.0680417956319,"Q2"
"1642","2476",14004.5298015246,61789.6641560256,63,98,0.378508179448545,35,21.7522137193009,"Q2"
"1643","2477",15045.5365044437,61769.9294888521,61,102,0.320921128848568,41,27.8422337172087,"Q2"
"1644","2478",12190.4607865161,61824.6247017431,55,100,0.899467689683661,45,4.52395396423526,"Q4"
"1645","2479",12253.2526741489,61815.671832126,45,76,0.529256649781018,31,14.5930438567884,"Q3"
"1646","248",12330.1395967831,61820.0720010628,59,96,0.719588294625282,37,10.3752330988646,"Q4"
"1647","2480",12515.0276567129,61811.2124653011,53,92,0.528862235601991,39,18.3743728115223,"Q3"
"1648","2481",20014.6428781724,61666.354949628,48,111,0.089515122352168,63,57.3605472918134,"Q1"
"1649","2482",17103.0238479201,61754.7884805083,63,101,0.00337471906095743,38,37.8717606756836,"Q2"
"1650","2483",14878.6965010927,61775.5902642508,69,104,0.286035895114765,35,24.9887436709832,"Q2"
"1651","2484",16395.6543938645,61753.0592399709,51,94,0.187372205778956,43,34.9429951515049,"Q2"
"1652","2485",12265.8137278349,61822.3323223467,57,96,0.800563198979944,39,7.77803523978218,"Q4"
"1653","2486",12474.4126658139,61815.3136055463,57,105,0.670768522424623,48,15.8031109236181,"Q3"
"1654","2487",15214.1710724397,61741.6206082353,57,130,0.478627571836114,73,38.0601872559637,"Q1"
"1655","2488",13580.6940713498,61787.1922777229,64,120,0.525355183286592,56,26.5801097359508,"Q2"
"1656","2489",12083.7966941049,61826.3224652736,47,80,0.989502484211698,33,0.34641802101396,"Q4"
"1657","249",12325.4085609364,61822.3669438018,66,123,0.872740887803957,57,7.25376939517446,"Q4"
"1658","2490",22587.7745790011,61502.3132593517,77,154,0.0502016739919782,77,73.1344711026177,"Q1"
"1659","2491",14681.1970327133,61778.723392805,58,96,0.322987692197785,38,25.7264676964842,"Q2"
"1660","2492",20432.9126442629,61657.8461181978,51,115,0.0568704740144312,64,60.3602896630764,"Q1"
"1661","2493",16268.0642271626,61752.261729063,57,100,0.203904987080023,43,34.232085555559,"Q2"
"1662","2494",15747.8184436649,61773.2377569557,64,96,0.0887708442751318,32,29.1593329831958,"Q2"
"1663","2495",17345.3462977279,61750.6782734968,53,94,0.0239790645428002,41,40.0168583537452,"Q2"
"1664","2496",16097.4384432165,61738.4769590531,53,110,0.350795606616884,57,37.0046504228376,"Q1"
"1665","2497",15893.516489165,61757.9165034294,50,94,0.257434725062922,44,32.6728720972314,"Q2"
"1666","2498",12151.5203376053,61825.4978324997,55,99,0.931636961875483,44,3.00797367747873,"Q4"
"1667","2499",17002.1614875606,61731.4036886847,48,100,0.242550658993423,52,39.387365732342,"Q1"
"1668","25",12632.4405981432,61813.9365401516,62,133,0.770430042874068,71,16.2994669559412,"Q3"
"1669","250",16895.2084281219,61750.8662916977,61,101,0.0767226340249181,40,36.9310946390033,"Q2"
"1670","2500",12089.8531131319,61826.3224652736,48,102,0.990443931659684,54,0.516027690377086,"Q4"
"1671","251",14694.586483627,61774.9243406308,71,109,0.348336894065142,38,24.7631980255246,"Q2"
"1672","252",17776.0445067007,61729.4196286502,53,101,0.0987867144867778,48,43.2582377046347,"Q1"
"1673","253",14666.2987541018,61779.1602948671,57,95,0.322819225722924,38,25.7328694225289,"Q2"
"1674","254",14701.6090022209,61755.0649538425,72,137,0.511279936647043,65,31.7668041179422,"Q2"
"1675","255",12408.6908220768,61815.7285933257,52,96,0.64028891408816,44,15.827287780121,"Q3"
"1676","256",17152.5718463162,61721.4416800646,54,109,0.252204515738413,55,41.1287516343873,"Q1"
"1677","257",12180.7315808413,61825.9507303846,60,133,0.959002768155187,73,2.99279792467132,"Q4"
"1678","258",12531.2241661987,61817.0407189728,68,130,0.79457915131934,62,12.7360926182009,"Q3"
"1679","259",12324.4904902882,61820.4686193094,63,97,0.721330424305052,34,9.47476557362825,"Q4"
"1680","26",20289.2634243368,61653.4267678276,59,122,0.0589752760715783,63,59.2845576074906,"Q1"
"1681","260",12335.7607667899,61818.8889624041,54,92,0.679697612766176,38,12.1714907148853,"Q3"
"1682","261",16869.0700799595,61759.1349591092,46,84,0.0565048626158386,38,35.8528152205981,"Q2"
"1683","262",15048.7885570393,61757.7369540278,55,113,0.426398475887254,58,33.2688883985393,"Q2"
"1684","263",17898.6355055037,61712.7373483148,57,110,0.160464401589707,53,44.4953867157456,"Q1"
"1685","264",12109.7362984798,61825.6729745784,38,78,0.936758190626279,40,2.52967237494886,"Q4"
"1686","265",16116.3118073588,61752.4914206893,41,87,0.323388822376728,46,31.1241141706705,"Q2"
"1687","266",21420.822308578,61604.2715510356,62,132,0.0504495766945183,70,66.4685296313837,"Q1"
"1688","267",15007.6258875289,61780.9801836559,49,82,0.219670966267586,33,25.7508581131697,"Q2"
"1689","268",16736.3211264948,61724.6533231661,58,114,0.300691639538854,56,39.1612681858242,"Q1"
"1690","269",12541.0529351561,61816.2172403242,60,125,0.775503230281174,65,14.5922900317237,"Q3"
"1691","27",12095.8299800025,61826.3224652736,60,93,0.977374013047665,33,0.746657569427043,"Q4"
"1692","270",20045.3341741405,61672.888458365,51,112,0.0525633161887527,61,57.7936377124861,"Q1"
"1693","271",12159.3899792547,61825.3342347658,70,102,0.916319951182231,32,2.6777615621686,"Q4"
"1694","272",14617.8573706233,61768.5296233886,54,109,0.436375647317618,55,30.999339397531,"Q2"
"1695","273",18258.6073048649,61642.2980392048,69,143,0.339927861467004,74,48.8453382514417,"Q1"
"1696","274",14573.1381468334,61776.8106910256,57,100,0.375982370460406,43,26.8327580702025,"Q2"
"1697","275",12762.0540339248,61809.265455386,61,136,0.729144120123237,75,20.3141909907572,"Q3"
"1698","276",12327.0576915362,61821.3676069053,59,107,0.812085098586977,48,9.01991526782513,"Q4"
"1699","277",22530.3079270377,61608.0190796216,43,115,0.00744598521851003,72,71.4638890642673,"Q1"
"1700","278",17447.9576423802,61721.2877520174,53,106,0.203208176419139,53,42.2299666497856,"Q1"
"1701","279",15418.482167828,61765.3656183536,51,94,0.292787436163053,43,30.4101402449887,"Q2"
"1702","28",12492.390554232,61812.2265540604,56,100,0.583203858463094,44,18.3390302276239,"Q3"
"1703","280",16773.7867577069,61766.8020833954,43,77,0.00856619467958808,34,33.708749380894,"Q2"
"1704","281",12285.1850555177,61821.0090882308,54,91,0.738533187890425,37,9.67427204805426,"Q4"
"1705","282",14970.8014344262,61775.1098922116,70,104,0.261420541908592,34,25.1117015751079,"Q2"
"1706","283",14423.3999875763,61776.7594820992,68,111,0.412998036248609,43,25.2410844413098,"Q2"
"1707","284",12171.4228206301,61823.6803057047,47,78,0.808812050847337,31,5.92682642373256,"Q4"
"1708","285",12516.4457997815,61812.1053451707,50,83,0.495436338940635,33,16.650600814959,"Q3"
"1709","286",12169.940796914,61825.2261525515,63,104,0.921345044160262,41,3.22485318942927,"Q4"
"1710","287",18761.7266235314,61706.8723540222,55,108,0.0660252885427326,53,49.5006597072352,"Q1"
"1711","288",12323.0780623165,61819.3238211998,42,100,0.78230585413985,58,12.6262604598887,"Q4"
"1712","289",12114.3538298138,61826.3224652736,45,106,0.973184006288648,61,1.63577561639249,"Q4"
"1713","29",16213.8832178388,61751.5327944308,53,98,0.233006063383073,45,34.5147271477617,"Q2"
"1714","290",14694.4535988303,61775.4012359836,61,102,0.356388611951843,41,26.3880669099744,"Q2"
"1715","291",17593.4324170576,61742.0338258238,51,95,0.0524992689024657,44,41.6900321682915,"Q1"
"1716","292",19044.9410080761,61636.2476995759,55,131,0.284432505490258,76,54.3831295827404,"Q1"
"1717","293",19766.0359847055,61669.5519825512,69,126,0.0344477600883693,57,55.036477674963,"Q1"
"1718","294",12448.1455304245,61818.7958075511,53,122,0.816651545232162,69,12.6510433789808,"Q3"
"1719","295",12119.9307614183,61826.1493233678,56,98,0.958268025191501,42,1.75274294195697,"Q4"
"1720","296",16579.399708777,61743.3040952383,54,101,0.219141714740545,47,36.7003394071944,"Q1"
"1721","297",15192.9681686191,61763.8669402206,61,106,0.344207586487755,45,29.510658608051,"Q2"
"1722","298",21701.7633935772,61585.7135968038,64,136,0.0529624035116285,72,68.1867069471627,"Q1"
"1723","299",17056.9346166436,61748.6669566476,54,96,0.085283575579524,42,38.41808982566,"Q2"
"1724","3",12524.4557769838,61810.9313692383,47,106,0.6401437218301,59,21.2315204120241,"Q3"
"1725","30",19482.6952260756,61696.2162490786,48,104,0.0429386748000979,56,53.5954342111945,"Q1"
"1726","300",12130.8114613308,61825.7936090696,60,94,0.937196969520301,34,2.13530303630978,"Q4"
"1727","301",13165.3717415405,61800.7442184074,54,94,0.469364964868873,40,21.2254014052451,"Q3"
"1728","302",14904.4850005328,61773.2728590768,63,102,0.319062536582351,39,26.5565610732883,"Q2"
"1729","303",16941.9835578871,61705.7703833603,81,134,0.289071109844372,53,37.6792311782483,"Q1"
"1730","304",13985.9159187708,61789.6722551794,50,88,0.38386815181002,38,23.4130102312192,"Q2"
"1731","305",17151.2495478057,61756.9805853471,44,82,0.0325348658952862,38,36.7636750959791,"Q2"
"1732","306",17894.2482009465,61715.488133227,60,111,0.136845843633637,51,44.0208619746845,"Q1"
"1733","307",12808.9717895011,61802.1045401582,56,118,0.582255320390686,62,25.9001701357774,"Q3"
"1734","308",14770.1525949781,61763.0082692042,64,119,0.448533164337277,55,30.3306759614497,"Q2"
"1735","309",15743.3989288484,61762.526516311,48,90,0.25667868508026,42,31.2194952266291,"Q2"
"1736","31",12414.1022286922,61813.3310496684,48,94,0.600387673359364,46,18.3821670254692,"Q3"
"1737","310",13118.2061355805,61802.0865107559,43,80,0.484200371894985,37,19.0845862398855,"Q3"
"1738","311",14146.2711428969,61791.6010724923,55,86,0.30228975135833,31,21.6290177078918,"Q2"
"1739","312",18929.526459179,61637.089535442,72,139,0.239374781958759,67,50.9618896087632,"Q1"
"1740","313",19247.7870439728,61685.5287623378,59,116,0.0779829344246536,57,52.5549727377947,"Q1"
"1741","314",13211.7076381094,61801.1712835586,56,93,0.455753656569868,37,20.1371147069149,"Q3"
"1742","315",20786.4339693095,61606.8298272545,47,123,0.171648570569232,76,62.9547086367384,"Q1"
"1743","316",13623.5443719871,61784.6287814972,56,117,0.516284845769405,61,29.5066244080663,"Q2"
"1744","317",12158.7039206135,61825.4818377191,60,104,0.933116704924032,44,2.94286498334259,"Q4"
"1745","318",12153.5106894672,61825.4142099535,65,99,0.920437056804076,34,2.70514006866142,"Q4"
"1746","319",15505.264500468,61750.2458264714,62,115,0.381514324340969,53,32.7797408099286,"Q2"
"1747","32",13352.1589551031,61797.0034594222,59,101,0.475709509337321,42,22.0202006078325,"Q2"
"1748","320",17507.943878673,61704.4101707701,63,120,0.251469571143389,57,42.6662344448268,"Q1"
"1749","321",15999.7823973749,61751.4119710173,41,90,0.360435055335984,49,31.3386822885368,"Q2"
"1750","322",12385.4581470547,61819.3967348417,63,106,0.746598709141836,43,10.8962555069011,"Q4"
"1751","323",12723.5264801435,61809.2386034007,72,128,0.668820443097502,56,18.5460551865399,"Q3"
"1752","324",12082.9651299002,61826.3224652736,54,104,0.996472280239686,50,0.176385988015682,"Q4"
"1753","325",12786.9240769936,61808.5967930953,53,86,0.470895956736058,33,17.4604334277101,"Q3"
"1754","326",18708.1041609424,61654.9236503869,66,132,0.240768430288881,66,50.1092836009338,"Q1"
"1755","327",12882.068171183,61807.4422250886,63,96,0.487908292328939,33,16.899026353145,"Q3"
"1756","328",17661.9630912888,61694.2649945174,62,123,0.274644937366247,61,44.2466588206589,"Q1"
"1757","329",12288.4144954148,61817.4749630463,46,83,0.62556645902805,37,13.8540410159621,"Q3"
"1758","33",12274.3887151394,61823.2438346532,85,122,0.866765973391011,37,4.92965898453258,"Q4"
"1759","330",18451.6038987272,61689.5588060928,60,118,0.171667508548126,58,48.0432845042087,"Q1"
"1760","331",12443.3495389212,61818.4939440649,54,117,0.794098921818659,63,12.9717679254245,"Q3"
"1761","332",20223.5750874842,61673.1556666905,47,108,0.0459891404025257,61,58.1946624354459,"Q1"
"1762","333",12207.160485394,61824.0420913385,58,96,0.862831559265032,38,5.21240074792877,"Q4"
"1763","334",12332.644086798,61819.9496763646,58,96,0.720059914747253,38,10.6377232396044,"Q4"
"1764","335",12312.3995437926,61819.4552172252,55,89,0.668369733728468,34,11.2754290532321,"Q4"
"1765","336",13015.1011960227,61804.4326093653,55,91,0.466876573860645,36,19.1924433410168,"Q3"
"1766","337",14258.8444007368,61775.9889550387,69,118,0.465075914980844,49,26.2112801659387,"Q2"
"1767","338",19431.0047970567,61675.2467536034,60,119,0.0888320219237357,59,53.7589107064996,"Q1"
"1768","339",12080.5742679704,61826.3224652736,48,80,0.996095439651981,32,0.124945931136608,"Q4"
"1769","34",12114.3371524413,61826.3224652736,71,107,0.967407565098256,36,1.17332765646279,"Q4"
"1770","340",15304.1540900495,61766.9782293797,86,118,0.205168604152277,32,25.4346046671271,"Q2"
"1771","341",19939.0445988528,61689.2708052275,53,110,0.000501806382089853,57,56.9713970362209,"Q1"
"1772","342",12890.9782178272,61802.6148847374,63,135,0.655982931843027,72,24.769228907302,"Q3"
"1773","343",16859.3219463459,61750.9902294814,50,92,0.115405474090949,42,37.1529700881802,"Q2"
"1774","344",15205.3395757599,61777.3128138391,59,92,0.189572227420285,33,26.7441164951306,"Q2"
"1775","345",18740.9452367249,61674.9698270288,59,121,0.18953240592964,62,50.2489908323623,"Q1"
"1776","346",15612.4876540204,61733.3859158062,55,127,0.453347411938012,72,39.3589863404632,"Q1"
"1777","347",14330.6964298553,61767.8396490517,45,111,0.480026088654995,66,34.3182781487703,"Q2"
"1778","348",16622.0685701526,61763.3039742547,51,88,0.047392767155543,37,35.2464676152449,"Q2"
"1779","349",18454.339298936,61693.1587068483,62,118,0.148880849825218,56,47.6626724097878,"Q1"
"1780","35",12354.814952809,61820.0586123823,54,104,0.777601163135841,50,11.1199418432079,"Q4"
"1781","350",12299.2400096821,61822.5733631037,57,114,0.86631705891341,57,7.61992764193565,"Q4"
"1782","351",20926.8830828172,61613.642446402,62,131,0.0811992669478059,69,63.3972505806014,"Q1"
"1783","352",16347.2003373869,61760.257174246,39,76,0.19518585363403,37,29.7781234155409,"Q2"
"1784","353",15500.4942420164,61755.6575289372,61,109,0.34223811281845,48,31.5725705847144,"Q2"
"1785","354",15333.0641729186,61774.038948347,57,92,0.202274661278352,35,27.9203868552577,"Q2"
"1786","355",16971.4410414975,61724.882200412,71,119,0.212956811767071,48,37.7780730351806,"Q1"
"1787","356",12468.6657332297,61814.2550742922,50,103,0.664129549171776,53,17.8011338938959,"Q3"
"1788","357",20552.5850680316,61633.9951560606,52,121,0.10779550881125,69,61.5621098920237,"Q1"
"1789","358",14620.2732776946,61768.4838615702,54,109,0.436232874635607,55,31.0071918950416,"Q2"
"1790","359",15444.8950616441,61773.0330552075,47,83,0.217620938783512,36,28.1656462037936,"Q2"
"1791","36",12575.6039883113,61816.35579945,70,141,0.819318656343967,71,12.8283753995784,"Q3"
"1792","360",14493.5048686953,61784.2888534401,70,101,0.284506741445512,31,22.1802910151891,"Q2"
"1793","361",15717.2499518619,61739.9442930772,48,113,0.414860391523689,65,38.0340745509602,"Q1"
"1794","362",14125.6996314227,61787.2673952362,55,93,0.374717354075983,38,23.7607405451126,"Q2"
"1795","363",12113.1625144632,61825.7256405783,43,79,0.933105150004849,36,2.40821459982544,"Q4"
"1796","364",14667.8889999789,61782.6996732865,68,99,0.254353608004749,31,23.1150381518528,"Q2"
"1797","365",13588.3975669423,61789.452191953,55,106,0.484611631371081,51,26.2848068000749,"Q2"
"1798","366",15145.2140284904,61761.6633702542,57,107,0.379023384768516,50,31.0488307615742,"Q2"
"1799","367",14957.8910749569,61754.1790710667,69,128,0.466379717225209,59,31.4835966837127,"Q2"
"1800","368",12679.4722449779,61807.0187857147,60,113,0.587086593732238,53,21.8844105321914,"Q3"
"1801","369",12601.245322647,61812.3184222537,59,117,0.683091313345358,58,18.3807038259692,"Q3"
"1802","37",12914.863104757,61808.646352319,30,68,0.686562846181914,38,11.9106118450873,"Q3"
"1803","370",12227.3299309173,61824.7301809273,63,126,0.930280275875703,63,4.39234261983074,"Q4"
"1804","371",12329.8315076661,61818.6302747724,53,90,0.662719401530921,37,12.4793821433559,"Q3"
"1805","372",12179.6230463102,61825.3334064683,56,113,0.937320474302396,57,3.57273296476342,"Q4"
"1806","373",12412.5505391023,61818.9349950734,64,110,0.753586571197957,46,11.335017724894,"Q3"
"1807","374",12641.8989106528,61809.1876890387,64,114,0.605233507696539,50,19.738324615173,"Q3"
"1808","375",17895.0289520878,61735.338969694,57,102,0.0319701321423054,45,43.5613440535963,"Q1"
"1809","376",17666.3793810426,61682.3753790374,44,121,0.388954314636067,77,47.0505177730229,"Q1"
"1810","377",12348.1904488391,61820.8356412206,63,108,0.793384079588577,45,9.29771641851403,"Q4"
"1811","378",20591.9585340509,61646.2847797162,69,130,0.0102787083014846,61,60.3729987936094,"Q1"
"1812","379",21616.4882538028,61601.8460116849,50,124,0.0787541130557656,74,68.1721956338733,"Q1"
"1813","38",15063.730623814,61751.1759897995,58,123,0.460882430430502,65,35.0426420220174,"Q2"
"1814","380",12137.2900880117,61824.6287441382,42,77,0.876735646743327,35,4.31425236398354,"Q4"
"1815","381",13777.4733605087,61785.6265336152,55,107,0.476557032670826,52,27.2190343011171,"Q2"
"1816","382",13402.0545917688,61795.1806872825,48,92,0.458481478039175,44,23.8268149662763,"Q2"
"1817","383",12285.2250704914,61823.1761725382,61,119,0.887113244272768,58,6.54743183217943,"Q4"
"1818","384",12333.0925014258,61817.8315797585,53,88,0.623896080069244,35,13.1636371975765,"Q3"
"1819","385",14487.6436705365,61759.8243558128,58,130,0.5097005891148,72,35.3015575837344,"Q2"
"1820","386",12500.6464489276,61813.7797892428,50,107,0.67790735932067,57,18.3592805187218,"Q3"
"1821","387",14989.6509724717,61762.2774704061,50,105,0.409202577080578,55,32.4938582605682,"Q2"
"1822","388",14656.6312458489,61782.8368515508,45,80,0.319335649721324,35,23.8232522597536,"Q2"
"1823","389",15347.937332517,61772.1999065944,54,91,0.228002925869077,37,28.5638917428441,"Q2"
"1824","39",13320.1318507293,61801.4862251898,59,91,0.420567204244435,32,18.5418494641781,"Q3"
"1825","390",12706.9796962371,61810.2133423649,58,129,0.714799257926643,71,20.2492526872084,"Q3"
"1826","391",12388.0694174858,61818.4269945187,53,102,0.732214212650433,49,13.1215035801288,"Q3"
"1827","392",14863.7958956756,61776.423413433,53,92,0.307391720125452,39,27.0117229151074,"Q2"
"1828","393",15535.9756644715,61768.2929585182,51,90,0.233704322017729,39,29.8855314413086,"Q2"
"1829","394",14379.4572172203,61764.1692955135,58,127,0.506344583351165,69,34.0622237487696,"Q2"
"1830","395",12299.6132206845,61823.3149527457,56,131,0.910728144459426,75,6.69538916554302,"Q4"
"1831","396",16173.2965589527,61734.899322744,55,113,0.354342429898679,58,37.4481390658766,"Q1"
"1832","397",16557.3775623175,61748.6383932013,65,106,0.148814455838874,41,34.8986073106062,"Q2"
"1833","398",12239.2659912564,61820.2289199433,45,81,0.700701404130086,36,10.7747494513169,"Q4"
"1834","399",16004.1786712103,61750.5501705814,53,101,0.286063492996618,48,34.2689523361623,"Q2"
"1835","4",13372.0469694949,61791.3512197603,53,109,0.508285350166261,56,27.5360203906894,"Q2"
"1836","40",21917.5151024309,61605.6659453595,54,126,0.0272432286292315,72,70.0384875386953,"Q1"
"1837","400",13247.5669511711,61801.7621662773,50,84,0.425192081835121,34,19.5434692176059,"Q3"
"1838","401",13854.3518306837,61785.6425163088,68,114,0.478001184295863,46,24.0119455223903,"Q2"
"1839","402",12801.3290808097,61803.0287755134,58,123,0.608445456018671,65,25.4510453587864,"Q3"
"1840","403",13522.3517917408,61797.9319942758,56,90,0.406317669665441,34,20.185199231375,"Q3"
"1841","404",17567.105527655,61682.1806921483,63,131,0.337464961921796,68,45.0523825893179,"Q1"
"1842","405",12347.2062377573,61821.2873701025,58,114,0.835075846174732,56,9.23575261421502,"Q4"
"1843","406",12363.1450056246,61821.7366515861,56,130,0.882231184979901,74,8.71489231148735,"Q4"
"1844","407",16503.0749399869,61757.2364679795,62,100,0.0954187598545104,38,34.3740871255286,"Q2"
"1845","408",13018.9539419396,61796.2450257862,55,120,0.563355102436617,65,28.3819183416199,"Q2"
"1846","409",13057.3274945636,61797.1177096215,73,142,0.634621682576835,69,25.2111039021984,"Q2"
"1847","41",16922.0171015213,61738.2855492334,59,105,0.173035525716841,46,38.0403658170253,"Q1"
"1848","410",12613.446542315,61810.45873289,63,102,0.54957066080533,39,17.5667442285921,"Q3"
"1849","411",19621.0703731353,61660.6338610603,52,117,0.142126308986917,65,55.7617899158504,"Q1"
"1850","412",13278.5270944768,61794.0393698717,49,101,0.492261645849794,52,26.4023944158107,"Q2"
"1851","413",15383.2960764135,61762.5489926657,48,95,0.338020365219563,47,31.1130428346805,"Q2"
"1852","414",16262.0647867131,61768.8250226531,65,98,0.0235024301800877,33,32.2244198040571,"Q2"
"1853","415",12421.5101053884,61815.7024376678,47,101,0.69187822449021,54,16.6385758775286,"Q3"
"1854","416",12269.8963750885,61824.3335174404,68,144,0.936402829596773,76,4.83338495064527,"Q4"
"1855","417",12598.805199502,61812.7983411594,66,118,0.677013356238604,52,16.7953054755926,"Q3"
"1856","418",14844.563277449,61768.6531450053,72,114,0.373418281553313,42,26.3164321747608,"Q2"
"1857","419",16590.2714987347,61739.2601653239,64,110,0.218206967227161,46,35.9624795075506,"Q1"
"1858","42",12316.648996755,61814.9672037793,41,87,0.64324340946041,46,16.4108031648211,"Q3"
"1859","420",12335.9046268843,61820.5456099129,63,101,0.749734311830252,38,9.51009615045041,"Q4"
"1860","421",20341.8787756809,61577.8194886193,75,147,0.17622596770525,72,59.311730325222,"Q1"
"1861","422",16750.7860216643,61697.6105505838,59,134,0.417769113788381,75,43.6673164658714,"Q1"
"1862","423",13245.6834887973,61801.0125458177,84,115,0.486452472861856,31,15.9199733412825,"Q3"
"1863","424",13893.3493660634,61784.9020694268,71,116,0.477169568184763,45,23.5273694316857,"Q2"
"1864","425",19982.5970920144,61678.3542033304,47,107,0.0556140136905015,60,56.6631591785699,"Q1"
"1865","426",15197.0500847155,61758.0015131548,71,118,0.380439401138574,47,29.119348146487,"Q2"
"1866","427",15715.2063788878,61754.8179032167,45,95,0.351339679211378,50,32.4330160394311,"Q2"
"1867","428",18399.5348310814,61684.4349409639,46,111,0.257824740372598,65,48.2413918757811,"Q1"
"1868","429",21637.3447809948,61623.332217982,50,120,0.0282957041636109,70,68.0193007085472,"Q1"
"1869","43",12241.5465531594,61823.9668101772,53,114,0.903836883371696,61,5.86595011432655,"Q4"
"1870","430",12476.2242869399,61817.5819664209,57,118,0.776409541722387,61,13.6390179549344,"Q3"
"1871","431",12175.5806532887,61825.6839655796,61,122,0.950208427151665,61,3.03728594374843,"Q4"
"1872","432",18480.4330689361,61676.8741445496,52,118,0.245406500296667,66,49.80317098042,"Q1"
"1873","433",12706.3464145918,61803.550639822,49,104,0.54265443701297,55,25.1540059642866,"Q3"
"1874","434",12703.2422605407,61806.5009324249,54,100,0.532311994349584,46,21.5136482599191,"Q3"
"1875","435",13904.1290428833,61787.6390378591,38,85,0.523258188040927,47,22.4068651620764,"Q2"
"1876","436",12203.103449848,61824.8941029563,55,115,0.927435788558796,60,4.35385268647224,"Q4"
"1877","437",15795.5610902298,61745.0963482635,51,108,0.370148552814499,57,35.9015324895736,"Q1"
"1878","438",12368.946075645,61820.3697556969,65,110,0.785438127350062,45,9.6552842692472,"Q4"
"1879","439",16122.9534232073,61726.0512202007,48,118,0.415227457880974,70,40.9340779483318,"Q1"
"1880","44",12410.9432960535,61815.8315583758,54,96,0.632947709644213,42,15.416196194943,"Q3"
"1881","440",12303.9520012086,61821.6787569574,55,103,0.813805579207838,48,8.9373321980238,"Q4"
"1882","441",16976.8614591533,61700.7857823353,56,126,0.376187131041661,70,43.6669008270837,"Q1"
"1883","442",12500.4458292497,61817.4489659141,52,126,0.80823116004467,74,14.1908941566944,"Q3"
"1884","443",17778.0891599939,61686.3134819494,81,135,0.216350805945694,54,42.3170564789325,"Q1"
"1885","444",12585.2433861366,61812.0382772787,61,113,0.650535272900015,52,18.1721658091992,"Q3"
"1886","445",17969.1033337518,61731.9549111127,47,94,0.0735809046309441,47,43.5416974823456,"Q1"
"1887","446",12653.1473171243,61812.3321025417,54,129,0.746420491952449,75,19.0184631035663,"Q3"
"1888","447",15843.3840153903,61729.4743068802,68,131,0.428990207612514,63,35.9736169204116,"Q1"
"1889","448",16735.7128267685,61764.0977209479,40,74,0.0551548455841839,34,32.1247352501377,"Q2"
"1890","449",12854.8948184465,61805.5260818684,59,100,0.515053392620757,41,19.882810902549,"Q3"
"1891","45",17601.2317118191,61741.7885646676,47,91,0.0663885113317519,44,41.0789055014029,"Q1"
"1892","450",13349.5502949236,61798.5088120878,61,99,0.461138527141884,38,20.4767359686084,"Q3"
"1893","451",12581.299360515,61811.4546023197,68,110,0.59358185227029,42,17.0695622046478,"Q3"
"1894","452",17062.0592131083,61754.0810576574,53,93,0.0442737578414381,40,38.2290496863425,"Q2"
"1895","453",12096.5575079641,61826.3224652736,57,126,0.991673823446035,69,0.574506182223558,"Q4"
"1896","454",16052.7712356346,61743.9135421055,58,109,0.314795569749549,51,34.945425942773,"Q1"
"1897","455",12267.7664848177,61822.1092692728,48,98,0.824425008380786,50,8.77874958096072,"Q4"
"1898","456",12288.7257439221,61821.9578086007,58,100,0.803261881927028,42,8.26300095906481,"Q4"
"1899","457",13002.3856582429,61798.5119198749,61,120,0.566641432000324,59,25.5681555119809,"Q3"
"1900","458",12361.4590851923,61820.3434702801,51,110,0.812657756963745,59,11.0531923391391,"Q4"
"1901","459",17619.1353885475,61737.277734629,73,114,0.00985980406403542,41,40.5957480333745,"Q1"
"1902","46",17105.8575978462,61754.1805051026,64,102,0.00464214524254203,38,37.8235984807834,"Q2"
"1903","460",14256.0352331766,61780.0405333994,61,106,0.424537719925866,45,25.8958026033361,"Q2"
"1904","461",12287.5211569807,61823.4574664539,66,128,0.904602044960484,62,5.91467321245,"Q4"
"1905","462",16348.0399197854,61747.0223676216,56,102,0.232851141598076,46,35.2888474864885,"Q2"
"1906","463",20098.6181363943,61650.1536777603,62,125,0.0802071457728744,63,57.9469498163089,"Q1"
"1907","464",13568.1323214081,61793.6370787074,56,98,0.450813136529177,42,23.0658482657745,"Q2"
"1908","465",12348.6814799529,61819.6314576578,59,98,0.719660728937015,39,10.9332315714564,"Q4"
"1909","466",12282.2886742237,61821.7091379539,48,99,0.816422134172171,51,9.36247115721926,"Q4"
"1910","467",19137.8907291886,61652.7927655977,55,124,0.22246707091108,69,53.6497721071355,"Q1"
"1911","468",12363.060652146,61821.4748596028,71,125,0.853355715051293,54,7.91879138723016,"Q4"
"1912","469",12249.4934027339,61823.6257058384,52,111,0.891347036929801,59,6.41052482114173,"Q4"
"1913","47",13588.543747758,61797.4936145801,56,89,0.391368525102735,33,20.0848386716098,"Q3"
"1914","470",16495.9593716763,61763.8090729482,44,80,0.0916216904297471,36,32.7016191445291,"Q2"
"1915","471",15774.5744072139,61761.9225679579,50,92,0.246605497086421,42,31.6425691223703,"Q2"
"1916","472",12308.9628361823,61821.1646820151,56,99,0.779816737398505,43,9.46788029186428,"Q4"
"1917","473",16600.0443808668,61732.8222743816,46,102,0.321734211407602,56,37.9828841611743,"Q1"
"1918","474",12110.1178832751,61826.3224652736,60,113,0.979196498170495,53,1.10258559696376,"Q4"
"1919","475",15713.2532839918,61763.2754711218,40,81,0.325865834252909,41,27.6395007956307,"Q2"
"1920","476",12592.732225932,61813.4751155741,69,120,0.690454886294901,51,15.78680079896,"Q3"
"1921","477",21105.6604617885,61632.3027627358,57,124,0.0351856688503176,67,64.6425601870287,"Q1"
"1922","478",12495.5238098459,61814.3619441426,55,106,0.66596603882499,51,17.0357320199255,"Q3"
"1923","479",13832.7970237944,61788.1962755758,51,96,0.436025627190247,45,25.3788467764389,"Q2"
"1924","48",20633.3401754955,61605.1977070573,63,134,0.130170750198886,71,61.7578767358791,"Q1"
"1925","480",13096.4355832073,61802.5282404875,61,99,0.48494934476912,38,19.5719248987734,"Q3"
"1926","481",12685.2635763,61806.0502002118,55,115,0.60132342739962,60,23.9205943560228,"Q3"
"1927","482",15850.1796677719,61774.234610221,54,87,0.0799358114600182,33,30.3621182218194,"Q2"
"1928","483",15038.0392591471,61761.2882868006,83,124,0.364730632165447,41,26.0460440812167,"Q2"
"1929","484",12240.3568780667,61821.7992717632,52,84,0.731357143027708,32,8.59657142311335,"Q4"
"1930","485",12280.6774326503,61820.8198751523,56,88,0.701197253772989,32,9.56168787926435,"Q4"
"1931","486",12473.0715780813,61814.6106851554,48,106,0.693608231376857,58,17.7707225801423,"Q3"
"1932","487",18440.4898891103,61705.5190807483,59,112,0.105074371444061,53,47.4310583134647,"Q1"
"1933","488",12383.835357246,61815.0616111327,54,86,0.530062771402299,32,15.0379913151264,"Q3"
"1934","489",12877.8091407099,61803.2483657069,58,106,0.534261675085872,48,22.3554395958781,"Q3"
"1935","49",18383.4493064121,61688.7403670531,51,113,0.216683370759711,62,48.5656310128979,"Q1"
"1936","490",12715.1928459443,61806.7992780829,63,119,0.610928281908855,56,21.7880162131041,"Q3"
"1937","491",14743.9206638002,61778.2330676088,52,91,0.319558210205287,39,26.5372298019938,"Q2"
"1938","492",15767.8142930013,61768.3258574429,62,97,0.146796606713906,35,29.8621187650133,"Q2"
"1939","493",12188.8698613054,61823.8609553583,52,85,0.829017775366083,33,5.64241341291927,"Q4"
"1940","494",15880.5623550731,61742.470159193,56,112,0.363126180367544,56,35.6649338994175,"Q1"
"1941","495",12183.4072015542,61824.9029385574,54,103,0.914966018637642,49,4.16666508675553,"Q4"
"1942","496",12623.3886468527,61814.9088919389,73,143,0.804740108782426,70,13.6681923852302,"Q3"
"1943","497",17342.8629482608,61704.6575963199,62,121,0.282898923847824,59,42.3089634929784,"Q1"
"1944","498",13920.8174063613,61790.0019766584,51,90,0.396129170432687,39,23.5509623531252,"Q2"
"1945","499",12815.8055402454,61805.6241537841,46,84,0.479642688762397,38,19.7735778270289,"Q3"
"1946","5",12214.70761837,61823.7708473995,56,95,0.852685970487073,39,5.74524715100415,"Q4"
"1947","50",12385.4474053746,61814.3462391951,39,73,0.604981313925236,34,13.430635326542,"Q3"
"1948","500",12581.0182795918,61809.0767063241,55,101,0.553559091407806,46,20.5362817952409,"Q3"
"1949","501",14128.7327321215,61783.4999761229,51,96,0.415160916512832,45,26.3177587569226,"Q2"
"1950","502",18471.9583437739,61711.2759051652,51,104,0.0988944114651531,53,47.7585961923469,"Q1"
"1951","503",12393.8082369906,61813.1877619369,48,91,0.575834116432816,43,18.2391329933889,"Q3"
"1952","504",12092.7946596778,61826.3224652736,54,95,0.984026214806363,41,0.654925192939118,"Q4"
"1953","505",17949.7403857267,61692.8820594451,53,116,0.26005449751392,63,46.616566656623,"Q1"
"1954","506",18704.5640208784,61694.7167363782,42,100,0.189936230191961,58,46.9836986488663,"Q1"
"1955","507",12384.9652265481,61814.0805719376,48,91,0.593058449681848,43,17.4984866636805,"Q3"
"1956","508",12375.2367084681,61820.022070549,58,109,0.788542365888134,51,10.7843393397052,"Q4"
"1957","509",12203.804363334,61823.2700379524,50,85,0.808998508611694,35,6.68505219859071,"Q4"
"1958","51",12326.7807558407,61819.3001195633,58,91,0.66280645201914,33,11.1273870833684,"Q4"
"1959","510",14705.6512584596,61780.9140898515,54,90,0.292477358132601,36,25.4708151072264,"Q2"
"1960","511",12370.0967749282,61817.1234651788,56,92,0.621121380943805,36,13.639630286023,"Q3"
"1961","512",19019.5019727159,61686.1712330314,60,117,0.102635239716619,57,51.1497913361527,"Q1"
"1962","513",12093.5643863306,61826.3224652736,56,103,0.987074009608477,47,0.607521548401564,"Q4"
"1963","514",15791.1800055349,61762.9825028193,38,78,0.328941796207801,40,26.842328151688,"Q2"
"1964","515",15250.7076945408,61749.2341063128,56,119,0.439009507419541,63,35.3424010325689,"Q2"
"1965","516",17037.6864631252,61712.2262311632,52,115,0.326011455385014,63,42.4612783107441,"Q1"
"1966","517",15770.1535279262,61763.533210724,69,105,0.177905789576471,36,29.595391575247,"Q2"
"1967","518",12972.2953469715,61804.5286066773,48,84,0.459151855902746,36,19.4705331875011,"Q3"
"1968","519",18167.4167819718,61734.7239349472,50,96,0.0169683729764074,46,45.2194548430853,"Q1"
"1969","52",17646.2217033694,61715.4926762007,78,124,0.111726893577725,46,40.8605628954247,"Q1"
"1970","520",15456.8196206735,61751.9193969935,53,109,0.387818911112845,56,34.2821409776807,"Q2"
"1971","521",15047.7513496652,61763.5804327383,71,115,0.369155989028513,44,27.7571364827454,"Q2"
"1972","522",12565.9213797958,61811.9389903999,51,112,0.67235337686725,61,19.9864440110978,"Q3"
"1973","523",14803.2165984701,61780.7162647005,58,92,0.260391388786957,34,25.1466927812435,"Q2"
"1974","524",12160.0457047253,61824.8254933786,55,86,0.874650806654245,31,3.88582499371842,"Q4"
"1975","525",12156.0607175329,61826.3224652736,67,140,0.971763897687197,73,2.06123546883464,"Q4"
"1976","526",12288.6382427363,61819.1932333892,36,92,0.789402412483469,56,11.7934649009258,"Q4"
"1977","527",12117.7851200443,61825.5960521217,41,81,0.931413504993543,40,2.74345980025828,"Q4"
"1978","528",12127.9240174821,61826.1037813954,58,103,0.957303802715614,45,1.92132887779735,"Q4"
"1979","529",12107.7739752905,61826.3224652736,55,131,0.987950010923669,76,0.915799169801176,"Q4"
"1980","53",13972.6579200081,61776.1070191561,78,135,0.539469153620303,57,26.2502582436427,"Q2"
"1981","530",12295.5095222833,61822.3586595687,55,109,0.851015966385603,54,8.04513781517744,"Q4"
"1982","531",19254.3800870131,61666.5891857885,57,120,0.153221935266629,63,53.3470180782024,"Q1"
"1983","532",17900.3774510545,61699.9378930648,50,111,0.248032154515386,61,45.8700385745615,"Q1"
"1984","533",16292.5017266452,61739.9550921926,55,107,0.299032651819289,52,36.450302105397,"Q1"
"1985","534",17876.5279104703,61718.9485114758,66,114,0.100612222217023,48,43.1706133335829,"Q1"
"1986","535",12388.3340684819,61819.0677356723,57,105,0.750685797771439,48,11.9670817069709,"Q4"
"1987","536",16028.4852481164,61773.8137395017,53,86,0.0488947727717459,33,31.3864724985324,"Q2"
"1988","537",13505.9035280954,61789.9726659733,40,94,0.524744977243245,54,25.6637712288648,"Q2"
"1989","538",17150.6059319832,61738.3779244572,47,94,0.170881312107667,47,38.9685783309396,"Q1"
"1990","539",12354.0450751423,61817.7612266948,56,91,0.629425549181178,35,12.9701057786588,"Q3"
"1991","54",12487.8298325961,61816.2239367303,53,113,0.74000212457031,60,15.5998725257814,"Q3"
"1992","540",12329.6592678524,61818.5820060361,56,89,0.635270465165377,33,12.0360746495426,"Q3"
"1993","541",19176.2855612141,61678.1968923008,49,111,0.15126149635762,62,52.6217872258276,"Q1"
"1994","542",15546.2633223715,61757.6304919124,45,95,0.363876366987824,50,31.8061816506088,"Q2"
"1995","543",12414.1667785484,61817.8424303319,56,104,0.720429318025708,48,13.419392734766,"Q3"
"1996","544",17150.5953016823,61729.44817588,68,114,0.159322514431551,46,38.6711643361486,"Q1"
"1997","545",14484.8451011911,61783.5750195286,49,86,0.331253518816084,37,24.7436198038049,"Q2"
"1998","546",12341.107142307,61821.8968035601,55,122,0.870797219220549,67,8.65658631222323,"Q4"
"1999","547",15472.725809469,61750.1913829848,57,113,0.393089940072969,56,33.9869633559138,"Q2"
"2000","548",15165.9102206281,61748.8704824819,49,117,0.450147493043914,68,37.3899704730138,"Q2"
"2001","549",12286.3836975512,61819.8172901848,51,86,0.679902118165046,35,11.2034258642234,"Q4"
"2002","55",12224.7821927642,61824.2160699941,63,110,0.89618651359342,47,4.87923386110924,"Q4"
"2003","550",14859.1321472382,61773.0724283152,63,103,0.334222018253058,40,26.6311192698777,"Q2"
"2004","551",12498.020781346,61816.3116570616,62,114,0.725344259291887,52,14.2820985168219,"Q3"
"2005","552",12341.1854964669,61821.9853774279,54,124,0.877165517071262,70,8.59841380501166,"Q4"
"2006","553",12440.2452662478,61810.3052626449,44,97,0.596310088178143,53,21.3955653265584,"Q3"
"2007","554",12098.1858531976,61826.3224652736,50,85,0.967709212331101,35,1.13017756841145,"Q4"
"2008","555",12260.0004128836,61822.2593548229,57,93,0.783023241907358,36,7.81116329133511,"Q4"
"2009","556",19611.4325629836,61679.8441124689,55,114,0.0664196144789457,59,55.0812427457422,"Q1"
"2010","557",12286.7833628283,61822.5894109336,61,108,0.84545293613337,47,7.26371200173162,"Q4"
"2011","558",18237.8464736329,61679.028897314,83,136,0.156501603778452,53,44.7054149997421,"Q1"
"2012","559",13295.5813047873,61801.6007989762,53,86,0.417260063113645,33,19.2304179172497,"Q3"
"2013","56",12771.9503283336,61807.2214036224,66,129,0.665265581803396,63,21.088268346386,"Q3"
"2014","560",12303.7622638291,61823.2753327056,64,133,0.909127909690142,69,6.27017423138022,"Q4"
"2015","561",12126.8894722356,61825.9038692019,60,95,0.943870828486979,35,1.96452100295573,"Q4"
"2016","562",12596.9165500746,61810.6647902871,50,114,0.66760428249836,64,21.273325920105,"Q3"
"2017","563",12214.112180905,61823.7054421313,62,93,0.826550084864721,31,5.37694736919366,"Q4"
"2018","564",19652.0016012574,61614.3624211624,57,134,0.253320012241602,77,57.4943590573967,"Q1"
"2019","565",17301.4102280016,61717.6633654134,56,111,0.240523635176942,55,41.7712000652682,"Q1"
"2020","566",12235.432343631,61823.8738858601,71,109,0.872190575581044,38,4.85675812792033,"Q4"
"2021","567",19686.7182683814,61646.3924466104,62,127,0.1428021278698,65,55.717861688463,"Q1"
"2022","568",13806.6097881545,61791.7621314116,57,95,0.408944684546441,38,22.4601019872352,"Q2"
"2023","569",17677.2833586704,61696.7088808153,41,109,0.366851686267182,68,43.0540853338316,"Q1"
"2024","57",17960.0638741394,61704.7422206162,54,111,0.200660468544811,57,45.5623532929458,"Q1"
"2025","570",12506.9881305666,61817.5148456617,75,128,0.78271343302913,53,11.5161880494561,"Q3"
"2026","571",15271.8370789213,61778.5475454836,50,83,0.17749529122375,33,27.1426553896163,"Q2"
"2027","572",12518.7928586452,61805.1627414011,42,100,0.566905615618452,58,25.1194742941298,"Q3"
"2028","573",12987.0574484456,61802.6094580489,67,111,0.537309887586161,44,20.3583649462089,"Q3"
"2029","574",12744.9607453923,61806.8878106481,60,124,0.648575772764161,64,22.4911505430937,"Q3"
"2030","575",12390.2966153424,61820.5350605573,57,121,0.840265214908868,64,10.2230262458324,"Q4"
"2031","576",14525.1232855357,61772.7252065854,58,108,0.426178548950702,50,28.6910725524649,"Q2"
"2032","577",12129.8323499997,61825.746804258,57,91,0.933531092246994,34,2.25994286360219,"Q4"
"2033","578",16789.9296216507,61746.3567732806,58,101,0.141513028182089,43,36.9149397881702,"Q2"
"2034","579",12383.4705254316,61818.4227336297,56,100,0.711292803054675,44,12.7031166655943,"Q3"
"2035","58",15736.0145564123,61745.7837037505,68,118,0.351484218146652,50,32.4257890926674,"Q1"
"2036","580",12416.0379297482,61816.9003677215,56,100,0.675671477336437,44,14.2704549971968,"Q3"
"2037","581",12144.3541617416,61825.6551074336,56,99,0.937538197496906,43,2.68585750763305,"Q4"
"2038","582",12649.5432973802,61807.3177549325,54,101,0.542345447232947,47,21.5097639800515,"Q3"
"2039","583",21353.5463914331,61589.8475621377,66,137,0.0724052041769028,71,65.8592305034399,"Q1"
"2040","584",14404.846495517,61788.2625989707,51,83,0.281181406229734,32,23.0021950006485,"Q2"
"2041","585",17044.5077720532,61741.4240601069,55,100,0.139124013483524,45,38.7394193932414,"Q1"
"2042","586",19927.8557293951,61612.3312131471,58,133,0.218793501611799,75,58.5904873791151,"Q1"
"2043","587",14489.774162841,61768.261905052,64,120,0.470666200621054,56,29.642692765221,"Q2"
"2044","588",12157.0995556518,61825.6951402784,60,110,0.945116169052199,50,2.74419154739007,"Q4"
"2045","589",12331.9359988173,61822.2514685105,66,124,0.872504113474861,58,7.39476141845807,"Q4"
"2046","59",12623.3749312175,61811.1910958865,59,117,0.666974832070991,58,19.3154597398825,"Q3"
"2047","590",20110.2138464989,61659.8098450214,36,99,0.156879363814369,63,53.1166000796948,"Q1"
"2048","591",18279.4720467755,61690.0135273131,57,117,0.20666160620749,60,47.6003036275506,"Q1"
"2049","592",14256.8426266967,61780.8666546636,51,97,0.411406176397577,46,27.0753158857115,"Q2"
"2050","593",12202.8402161391,61824.1723165669,54,97,0.877509877085686,43,5.26707528531551,"Q4"
"2051","594",13052.4039212878,61800.8479797141,72,118,0.552927451208234,46,20.5653372444212,"Q3"
"2052","595",12727.6731282426,61804.484079927,55,117,0.596767823444679,62,25.0003949464299,"Q3"
"2053","596",13502.6908131054,61797.0546681238,65,100,0.437622205121443,35,19.6832228207495,"Q2"
"2054","597",12679.6745538866,61807.71764365,57,101,0.538505686912686,44,20.3057497758418,"Q3"
"2055","598",20187.1817040767,61631.4793320774,57,126,0.13986683008261,69,59.3491887242999,"Q1"
"2056","599",14373.7521515218,61777.5538987441,63,108,0.419512055115774,45,26.1219575197902,"Q2"
"2057","6",12447.0731844813,61812.8082800869,54,95,0.56382675585337,41,17.8831030100118,"Q3"
"2058","60",17134.2559841987,61725.8176912566,53,106,0.232998549006879,53,40.6510769026354,"Q1"
"2059","600",12388.548483259,61814.047169017,52,89,0.548474865034223,37,16.7064299937338,"Q3"
"2060","601",13902.7697377743,61791.4660642986,61,96,0.385076819686219,35,21.5223113109823,"Q2"
"2061","602",18199.909818333,61696.918914371,78,128,0.110096423421055,50,44.4951788289472,"Q1"
"2062","603",12292.3928314417,61816.3150994114,41,86,0.66373505955562,45,15.1319223199971,"Q3"
"2063","604",15866.3553957942,61753.9301077821,56,102,0.28145623463206,46,33.0530132069252,"Q2"
"2064","605",19077.3715820867,61661.6168268615,47,116,0.236294577131048,69,52.6956741779577,"Q1"
"2065","606",15793.9368929359,61764.8946717758,38,76,0.302311601815745,38,26.5121591310017,"Q2"
"2066","607",12573.1138995159,61814.9971082339,73,125,0.73120604455471,52,13.9772856831551,"Q3"
"2067","608",13864.7256693109,61789.8403971344,41,83,0.476848532212898,42,21.9723616470583,"Q2"
"2068","609",12361.7799413407,61819.34507109,53,101,0.749013703083619,48,12.0473422519863,"Q4"
"2069","61",12751.0622418193,61802.2763995668,51,116,0.582920908695087,65,27.1101409348194,"Q3"
"2070","610",12498.3362532261,61813.8747954108,67,104,0.590252309571952,37,15.1606645458378,"Q3"
"2071","611",12188.5297515177,61823.4724180777,47,83,0.821421295404434,36,6.42883336544037,"Q4"
"2072","612",12422.0634970084,61818.1426976835,60,107,0.731352185131982,47,12.6264472987968,"Q3"
"2073","613",13342.163671215,61791.1078630452,58,117,0.532532506156713,59,27.5805821367539,"Q2"
"2074","614",12587.0012320656,61812.2065990036,65,98,0.533896249020472,33,15.3814237823244,"Q3"
"2075","615",13063.8740625449,61804.4326051283,57,91,0.456519422121346,34,18.4783396478742,"Q3"
"2076","616",12215.4455858719,61824.5856312675,82,121,0.909062385559082,39,3.5465669631958,"Q4"
"2077","617",12317.4519442451,61822.0391022144,49,116,0.867264922009781,67,8.89325022534467,"Q4"
"2078","618",12381.5960306475,61820.6739011203,68,119,0.822077458025888,51,9.07404964067973,"Q4"
"2079","619",12368.8594598066,61818.4391864387,55,97,0.697028530063108,42,12.7248017373495,"Q3"
"2080","62",18597.8152490847,61673.1971397235,58,122,0.221124448115006,64,49.8480353206396,"Q1"
"2081","620",12358.4977248411,61820.5568861204,54,110,0.81211531534791,56,10.521542340517,"Q4"
"2082","621",12475.9138448599,61816.8029635659,59,112,0.732070674654096,53,14.2002542433329,"Q3"
"2083","622",12481.886222153,61814.0442901066,59,102,0.617930691922083,43,16.4289802473504,"Q3"
"2084","623",12465.8550862613,61816.356640302,66,107,0.671261214883998,41,13.4782901897561,"Q3"
"2085","624",14118.3781127363,61775.1762731485,55,115,0.484833751339465,60,30.9099749196321,"Q2"
"2086","625",13696.7492911738,61796.808233075,52,84,0.365158950909972,32,20.3149135708809,"Q2"
"2087","626",20638.921234784,61635.035433694,60,126,0.067260327283293,66,61.5608183993027,"Q1"
"2088","627",14917.6408187438,61757.3358570103,65,123,0.455560338450596,58,31.5775003698654,"Q2"
"2089","628",13528.4980713922,61790.3294280863,61,112,0.504082983359694,51,25.2917678486556,"Q2"
"2090","629",19181.9075182995,61640.7265962945,55,128,0.252987442072481,73,54.5319167287089,"Q1"
"2091","63",18209.0603641303,61705.7195509598,58,112,0.14271865831688,54,46.2931924508885,"Q1"
"2092","630",12157.937924909,61825.6953668997,56,110,0.946194619871676,54,2.9054905269295,"Q4"
"2093","631",12227.8863184432,61819.200275923,45,76,0.630182066233829,31,11.4643559467513,"Q4"
"2094","632",13745.0690562994,61792.2811223857,56,95,0.419080395717174,39,22.6558645670302,"Q2"
"2095","633",12297.2521577548,61822.5804857105,67,113,0.850814859615639,46,6.86251645768061,"Q4"
"2096","634",16448.7101274916,61762.1567192,57,94,0.075144425034523,37,34.2196562737226,"Q2"
"2097","635",12678.6801084125,61812.7005085569,61,137,0.771194819593802,76,17.389193710871,"Q3"
"2098","636",12242.0387236998,61823.4922284169,63,103,0.854722644435242,40,5.81109422259033,"Q4"
"2099","637",15988.9149809481,61755.713206491,57,100,0.235784876393154,43,32.8612503150944,"Q2"
"2100","638",12091.4694429683,61826.3224652736,59,91,0.981891751056537,32,0.579463966190815,"Q4"
"2101","639",12796.4128553529,61804.5691015799,60,126,0.634449465200305,66,24.1263352967799,"Q3"
"2102","64",14346.7500192721,61761.5128980209,52,128,0.510747939348221,76,37.1831566095352,"Q2"
"2103","640",14545.0749308462,61778.2414455618,59,100,0.366605281829834,41,25.9691834449768,"Q2"
"2104","641",12469.225907948,61817.6481613205,60,116,0.764020123519003,56,13.2148730829358,"Q3"
"2105","642",20530.7428566532,61667.7133963358,49,111,0.0227611630689353,62,60.588807889726,"Q1"
"2106","643",12419.3293242008,61813.4960400267,52,93,0.571837286697701,41,17.5546712453943,"Q3"
"2107","644",12518.6362464494,61817.681489443,57,134,0.828842062503099,77,13.1791611872613,"Q3"
"2108","645",12103.920528524,61826.3224652736,55,91,0.966138724703342,36,1.2190059106797,"Q4"
"2109","646",12779.4245383243,61809.1523470882,56,88,0.47468438767828,32,16.810099594295,"Q3"
"2110","647",12396.3795221911,61814.0846789188,45,95,0.639387783128768,50,18.0306108435616,"Q3"
"2111","648",15603.4550741994,61779.2935908781,53,84,0.0750177842564881,31,28.6744486880489,"Q2"
"2112","649",16565.5769244873,61760.8039178592,64,100,0.0448492954019457,36,34.38542536553,"Q2"
"2113","65",12453.9507056151,61818.3136586282,53,119,0.799131953157485,66,13.257291091606,"Q3"
"2114","650",14958.1514972998,61756.5690728401,52,115,0.446613325038925,63,34.8633605225477,"Q2"
"2115","651",12140.8601855742,61825.8190579506,65,104,0.944267520913854,39,2.17356668435968,"Q4"
"2116","652",18246.7788433378,61674.1177799824,69,130,0.234845096478239,61,46.6744491148274,"Q1"
"2117","653",16984.7503140643,61731.0300839472,57,107,0.216322713298723,50,39.1838643350638,"Q1"
"2118","654",12444.2748556016,61814.8014584723,58,98,0.606558037223294,40,15.7376785110682,"Q3"
"2119","655",13553.5190611121,61790.4667892447,64,113,0.502877150196582,49,24.3590196403675,"Q2"
"2120","656",14816.3571380657,61778.8069422505,53,90,0.290904073510319,37,26.2365492801182,"Q2"
"2121","657",14662.8387886955,61784.4049419028,52,85,0.25992202362977,33,24.4225732202176,"Q2"
"2122","658",12223.6971372807,61818.5055595385,42,77,0.65189782413654,35,12.1835761552211,"Q3"
"2123","659",17388.0225089282,61710.1139078654,59,116,0.25638785935007,57,42.385892017046,"Q1"
"2124","66",12335.213285684,61822.2862331619,68,127,0.877836789004505,59,7.20762944873422,"Q4"
"2125","660",17372.4800245887,61689.6003358206,59,128,0.350770581513643,69,44.7968298755586,"Q1"
"2126","661",13857.4393007486,61787.8048018795,51,96,0.434298584237695,45,25.4565637093037,"Q2"
"2127","662",15740.3863076507,61740.8678305886,57,117,0.39825643459335,60,36.104613924399,"Q1"
"2128","663",12186.1291442517,61824.6549935854,56,98,0.895627326332033,42,4.38365229405463,"Q4"
"2129","664",15180.4174069657,61747.9164981293,48,117,0.452048904262483,69,37.8086256058887,"Q2"
"2130","665",12589.5488909397,61814.6542497095,57,127,0.764689367264509,70,16.4717442914844,"Q3"
"2131","666",16400.6405356296,61741.330375903,65,111,0.240689119091257,46,34.9283005218022,"Q1"
"2132","667",13123.3001340729,61800.6731190099,68,110,0.519744639052078,42,20.1707251598127,"Q3"
"2133","668",18512.5320070562,61659.9443642143,44,121,0.345114357769489,77,50.4261944517493,"Q1"
"2134","669",15035.2061414009,61778.0903576562,58,92,0.229214257793501,34,26.206715235021,"Q2"
"2135","67",12351.5987637811,61819.5430950316,66,98,0.684224681695923,32,10.1048101857305,"Q4"
"2136","670",12735.1998572887,61807.8971852273,68,125,0.645811086986214,57,20.1887680417858,"Q3"
"2137","671",12462.2510353789,61819.3404851885,61,134,0.849164900835603,73,11.0109622390009,"Q4"
"2138","672",12538.7842454284,61810.0518246706,54,103,0.579504634253681,49,20.6042729215696,"Q3"
"2139","673",17275.775609795,61707.829200195,62,120,0.279505935963243,58,41.7886557141319,"Q1"
"2140","674",13455.7822451641,61787.5550687847,70,132,0.567091519711539,62,26.8403257778846,"Q2"
"2141","675",12200.7148195845,61824.8689876546,48,114,0.929059013258666,66,4.68210512492806,"Q4"
"2142","676",17140.0819106342,61753.454793189,60,99,0.0164781508501619,39,38.3573521168437,"Q2"
"2143","677",15134.4585231017,61758.6731274705,54,109,0.404530815081671,55,32.7508051705081,"Q2"
"2144","678",18749.5423081735,61698.4457016839,57,112,0.0991745963692665,55,49.5453971996903,"Q1"
"2145","679",12348.443144571,61815.0629135301,50,86,0.55755519727245,36,15.9280128981918,"Q3"
"2146","68",12146.6404399346,61825.4832352772,54,95,0.927385461283848,41,2.97719608736224,"Q4"
"2147","680",18051.0427413396,61741.6777690976,33,73,0.0365382246673107,40,38.5384710133076,"Q1"
"2148","681",17774.1597250198,61725.5383709254,59,107,0.103437832323834,48,43.034984048456,"Q1"
"2149","682",12327.9077543919,61821.7121077061,67,112,0.823972834041342,45,7.9212224681396,"Q4"
"2150","683",12089.0245318211,61826.3224652736,43,77,0.975746929645538,34,0.824604392051697,"Q4"
"2151","684",12521.6014245286,61813.3661418312,53,108,0.666924122488126,55,18.3191732631531,"Q3"
"2152","685",12196.4445859359,61823.8835460943,52,89,0.845926052657887,37,5.70073605165817,"Q4"
"2153","686",12710.3726671952,61811.8622700185,67,140,0.765391960041597,73,17.1263869169634,"Q3"
"2154","687",16421.426869684,61730.6865965569,51,110,0.341025750618428,59,38.8794807135127,"Q1"
"2155","688",12884.9852486875,61801.3755197069,61,131,0.628780742874369,70,25.9853479987942,"Q3"
"2156","689",15230.5762886067,61747.2461924259,56,122,0.451912629418075,66,36.173766458407,"Q2"
"2157","69",12798.2408058052,61808.2005236915,70,139,0.717148096300662,69,19.5167813552544,"Q3"
"2158","690",15758.8064417003,61748.0970881599,76,120,0.305387151194736,44,30.5629653474316,"Q2"
"2159","691",13049.8774742617,61801.1185455606,62,107,0.520895089721307,45,21.5597209625412,"Q3"
"2160","692",14310.5143707283,61767.5228671665,61,126,0.505406251410022,65,32.1485936583485,"Q2"
"2161","693",16621.3560145124,61717.3982858858,56,120,0.363654242828488,64,40.7261284589767,"Q1"
"2162","694",12243.101724323,61823.2818978475,53,101,0.858755939872935,48,6.7797148860991,"Q4"
"2163","695",15115.3822113998,61773.5354297163,43,82,0.332618650048971,39,26.0278726480901,"Q2"
"2164","696",22330.6395009243,61585.8570778695,43,119,0.0728998286649585,76,70.4596130214632,"Q1"
"2165","697",12336.0937729252,61813.6521057956,45,86,0.571328351506963,41,17.5755375882145,"Q3"
"2166","698",14572.3729585885,61785.879492723,55,87,0.25876275356859,32,23.7195918858051,"Q2"
"2167","699",12153.9523272298,61826.0754826533,44,119,0.960569458082318,75,2.95729064382613,"Q4"
"2168","7",12493.0693924469,61816.4931758529,61,114,0.731191769940779,53,14.2468361931387,"Q3"
"2169","70",19021.2822182767,61635.7063412735,61,134,0.27029515337199,73,53.2684538038447,"Q1"
"2170","700",12253.4444885884,61821.5748281687,53,86,0.731013976270333,33,8.87653878307901,"Q4"
"2171","701",16340.8096518451,61751.0914774981,54,98,0.206560844555497,44,34.9113228395581,"Q2"
"2172","702",12487.06751826,61811.4943512766,54,98,0.565490385983139,44,19.1184230167419,"Q3"
"2173","703",12928.728734423,61800.982679086,57,110,0.542243106290698,53,24.261115366593,"Q3"
"2174","704",13568.2785723462,61797.9799957434,51,84,0.387054263846949,33,20.2272092930507,"Q3"
"2175","705",15060.7210728395,61770.0995969193,77,112,0.277438334655017,35,25.2896582870744,"Q2"
"2176","706",15127.3740354724,61770.0539248945,47,90,0.332385939545929,43,28.707404599525,"Q2"
"2177","707",15678.6044499594,61737.2514380819,53,120,0.427748048910871,67,38.3408807229716,"Q1"
"2178","708",12487.4087646334,61815.9751453107,52,112,0.733591897413135,60,15.9844861552119,"Q3"
"2179","709",12566.9637232772,61810.9120165648,56,108,0.618518325034529,52,19.8370470982045,"Q3"
"2180","71",12364.6973615727,61820.4482742034,71,110,0.77074609650299,39,8.94090223638341,"Q4"
"2181","710",12572.1184151491,61814.3427334873,49,124,0.761971010128036,75,17.8521742403973,"Q3"
"2182","711",13774.4648540924,61795.7632136478,53,85,0.356960417237133,32,20.5772666484118,"Q2"
"2183","712",12832.3842334239,61800.6829444104,51,126,0.61764165549539,75,28.6768758378457,"Q3"
"2184","713",12778.0098277594,61807.4434232029,62,131,0.685865422012284,69,21.6752858811524,"Q3"
"2185","714",12264.0291207233,61821.8181754171,35,107,0.872590759303421,72,9.1734653301537,"Q4"
"2186","715",12145.0775893491,61826.3224652736,61,130,0.971081095049158,69,1.99540444160812,"Q4"
"2187","716",12364.0481514109,61819.7873991284,65,103,0.732534724986181,38,10.1636804505251,"Q4"
"2188","717",12581.2388794406,61807.5530885587,46,109,0.616205679019913,63,24.1790422217455,"Q3"
"2189","718",12166.5060963846,61824.6828726547,54,87,0.872405854985118,33,4.21060678549111,"Q4"
"2190","719",12755.6092819122,61809.154064974,55,88,0.479729731567204,33,17.1689188582823,"Q3"
"2191","72",20521.7891625402,61573.946095999,75,147,0.161572537384927,72,60.3667773082852,"Q1"
"2192","720",15317.0128780493,61767.5865725694,52,94,0.291944862343371,42,29.7383157815784,"Q2"
"2193","721",12099.5094782245,61826.3224652736,54,96,0.977279812563211,42,0.95424787234515,"Q4"
"2194","722",14909.5966196146,61780.3931568815,54,88,0.24150021513924,34,25.7889926852658,"Q2"
"2195","723",17631.7817830208,61742.1836624686,62,104,0.0130853580776602,42,41.4504149607383,"Q1"
"2196","724",15386.3778683704,61773.5879885707,51,87,0.209337052423507,36,28.4638661127537,"Q2"
"2197","725",19047.837942551,61613.3493900096,76,147,0.270197440637276,71,51.8159817147534,"Q1"
"2198","726",14067.7689652894,61771.741440632,63,130,0.528192199999467,67,31.6111226000357,"Q2"
"2199","727",12569.8086469854,61810.6149744898,49,84,0.493889219127595,35,17.7138773305342,"Q3"
"2200","728",16459.4815181275,61750.1041157044,53,97,0.192795760929585,44,35.5169865190983,"Q2"
"2201","729",12210.8275597741,61823.8922344138,53,96,0.866059251828119,43,5.75945217139088,"Q4"
"2202","73",16118.8210444261,61746.5569501513,41,93,0.372889029793441,52,32.6097704507411,"Q2"
"2203","730",12253.6614003571,61821.2058933536,46,88,0.764537025708705,42,9.88944492023438,"Q4"
"2204","731",20457.0819959393,61652.9673374674,62,124,0.0313941221684217,62,60.0535644255579,"Q1"
"2205","732",13283.8064270184,61793.1469063237,47,100,0.491012100595981,53,26.976358668413,"Q2"
"2206","733",19956.1741998367,61597.916201401,65,140,0.22402697079815,75,58.1979771901388,"Q1"
"2207","734",12084.1491698587,61826.3224652736,51,107,0.995956401340663,56,0.226441524922848,"Q4"
"2208","735",21093.9104863492,61592.2287957377,59,133,0.121420392999426,74,65.0148909180425,"Q1"
"2209","736",12788.8778310905,61807.9217183418,65,135,0.704331564018503,70,20.6967905187048,"Q3"
"2210","737",12181.7286756039,61823.3573437107,46,80,0.808195025892928,34,6.52136911964044,"Q4"
"2211","738",13554.8580378845,61790.0492553689,55,106,0.486738343955949,51,26.1763444582466,"Q2"
"2212","739",13382.5966965367,61801.2130658812,46,77,0.409521826077253,31,18.3048233916052,"Q3"
"2213","74",14430.6377299935,61765.4025880424,54,120,0.485732232918963,66,33.9416726273485,"Q2"
"2214","740",12133.7582699183,61826.2709921414,67,116,0.964418549090624,49,1.74349109455943,"Q4"
"2215","741",12448.5982200366,61817.1315273825,73,108,0.663619754603133,35,11.7733085888904,"Q3"
"2216","742",13612.5091057248,61795.0024533861,68,103,0.433433941798285,35,19.82981203706,"Q2"
"2217","743",12164.358619247,61825.3364216233,53,103,0.930557411629707,50,3.47212941851467,"Q4"
"2218","744",18959.9032198666,61678.3994327193,64,122,0.126917727058753,58,50.6387718305923,"Q1"
"2219","745",16477.1696967836,61741.4471966845,63,109,0.229089145548642,46,35.4618993047625,"Q1"
"2220","746",20753.7764469324,61649.1098175817,41,106,0.0899876062758267,65,59.1508055920713,"Q1"
"2221","747",12446.1101882489,61817.5158457522,55,110,0.745968810049817,55,13.9717154472601,"Q3"
"2222","748",12410.7573028545,61818.8252313973,70,109,0.726006389362738,39,10.6857508148532,"Q3"
"2223","749",16916.0649171708,61664.9514391559,91,159,0.424321629106998,68,39.1461292207241,"Q1"
"2224","75",12230.4187796925,61824.7316425424,63,128,0.931985043454915,65,4.42097217543051,"Q4"
"2225","750",12625.3477432311,61804.1633478391,46,100,0.536582816159353,54,25.024527927395,"Q3"
"2226","751",12714.0762076934,61805.8810657311,57,118,0.611258577555418,61,23.7132267691195,"Q3"
"2227","752",19167.4539305435,61674.0256509001,51,114,0.159989315783605,63,52.9206731056329,"Q1"
"2228","753",18887.6963349466,61677.5359466243,68,125,0.12559743062593,57,49.840946454322,"Q1"
"2229","754",12247.0987185875,61817.9277372792,41,81,0.672636334784329,40,13.0945466086268,"Q3"
"2230","755",12311.1954342552,61818.1054664087,52,85,0.611677593551576,33,12.814639412798,"Q3"
"2231","756",12466.8335213497,61817.6351269852,56,116,0.771410977235064,60,13.7153413658962,"Q3"
"2232","757",12779.8283679711,61807.3031639472,59,98,0.515046182088554,39,18.9131988985464,"Q3"
"2233","758",13955.8353499733,61790.3957839487,59,95,0.383399089798331,36,22.1976327672601,"Q2"
"2234","759",15400.3826314424,61750.3877027844,58,115,0.40542981470935,57,33.890500561567,"Q2"
"2235","76",16803.3648598282,61750.2014887522,63,103,0.0931415199302137,40,36.2743392027915,"Q2"
"2236","760",12132.1263629492,61826.0497689088,70,108,0.95455768937245,38,1.7268078038469,"Q4"
"2237","761",12405.9717816107,61819.7526749816,63,116,0.800127520458773,53,10.593241415685,"Q4"
"2238","762",14909.0483811979,61778.3946524947,54,90,0.268675783416256,36,26.3276717970148,"Q2"
"2239","763",14426.3161916515,61779.4202878179,68,107,0.380636333487928,39,24.1551829939708,"Q2"
"2240","764",14871.0256741993,61762.7016229325,47,105,0.430822856258601,58,33.0122743370011,"Q2"
"2241","765",12260.5184657467,61822.7175247971,53,100,0.838105508126318,47,7.60904111806303,"Q4"
"2242","766",12152.9340630329,61824.6191119255,47,81,0.868841108866036,34,4.45940229855478,"Q4"
"2243","767",12173.4380004883,61825.4965861473,56,114,0.942535349866375,58,3.33294970775023,"Q4"
"2244","768",15778.8787241243,61737.4487614941,54,118,0.410965762799606,64,37.6981911808252,"Q1"
"2245","769",12971.2709662034,61798.9137774872,61,138,0.643195356009528,77,27.4739575872663,"Q3"
"2246","77",12097.565255626,61826.3224652736,75,107,0.981390303000808,32,0.595510303974152,"Q4"
"2247","770",12646.1896143285,61801.9160740733,44,112,0.581371767213568,68,28.4667198294774,"Q3"
"2248","771",12102.2634643263,61826.3224652736,54,113,0.984994439873844,59,0.885328047443181,"Q4"
"2249","772",12228.7650540974,61824.3045331647,65,115,0.905692877713591,50,4.71535611432046,"Q4"
"2250","773",19538.4032722524,61639.7539502596,63,130,0.178653438808396,67,55.0302195998374,"Q1"
"2251","774",15086.4289426933,61777.8097313415,57,91,0.220575431594625,34,26.5004353257827,"Q2"
"2252","775",13822.2187862235,61791.9524066347,51,89,0.398142843041569,38,22.8705719644204,"Q2"
"2253","776",12318.4901766898,61817.1240973282,48,86,0.623071793466806,38,14.3232718482614,"Q3"
"2254","777",19475.6466369365,61663.7004967742,57,120,0.133288566023111,63,54.602820340544,"Q1"
"2255","778",12378.4088526013,61821.3562725593,57,130,0.875213171355426,73,9.10943849105388,"Q4"
"2256","779",12246.9063977848,61822.8446331701,57,95,0.814605895197019,38,7.04497598251328,"Q4"
"2257","78",14696.9570858682,61778.2616022167,59,97,0.323160773841664,38,25.7198905940168,"Q2"
"2258","780",12894.7069000576,61802.732755866,62,136,0.663729887222871,74,24.8839883455075,"Q3"
"2259","781",14354.947034775,61772.6974311343,62,116,0.465767498593777,54,28.848555075936,"Q2"
"2260","782",12160.5088712213,61825.188120714,61,96,0.908714780118316,35,3.19498269585893,"Q4"
"2261","783",16167.3781859202,61705.4581525206,77,147,0.460476046195254,70,37.7666767663322,"Q1"
"2262","784",15786.3772728547,61757.1444504299,63,105,0.255556203657761,42,31.266639446374,"Q2"
"2263","785",12551.1606308039,61814.6995034016,74,118,0.682481851428747,44,13.9707985371351,"Q3"
"2264","786",14864.5869685151,61771.2875881378,54,99,0.361055803252384,45,28.7524888536427,"Q2"
"2265","787",12524.7998794132,61814.4364893448,58,111,0.686794083565474,53,16.5999135710299,"Q3"
"2266","788",15018.6869939912,61767.9931220371,54,100,0.355754631804302,46,29.6352869370021,"Q2"
"2267","789",12283.931073694,61823.4503723555,57,125,0.905151487095281,68,6.44969887752086,"Q4"
"2268","79",12544.2088662723,61813.9019444263,56,113,0.694031890714541,57,17.4401822292712,"Q3"
"2269","790",12280.7019211514,61821.1751610136,58,90,0.719056094298139,32,8.99020498245955,"Q4"
"2270","791",13286.1735616576,61800.362924604,59,95,0.450692364946008,36,19.7750748619437,"Q3"
"2271","792",12180.2101510889,61824.0146201821,50,84,0.839035582728684,34,5.47279018722475,"Q4"
"2272","793",15244.5374322974,61770.0428089668,58,97,0.271441166754812,39,28.4137944965623,"Q2"
"2273","794",12446.3829710981,61813.5476620835,54,88,0.524359742412344,34,16.1717687579803,"Q3"
"2274","795",12354.6472685163,61816.0883283024,55,87,0.55272606946528,32,14.3127657771111,"Q3"
"2275","796",15784.2583922466,61753.4920408183,60,106,0.295596388168633,46,32.4025661442429,"Q2"
"2276","797",12186.8870747103,61824.3450614082,53,92,0.873154707020149,39,4.9469664262142,"Q4"
"2277","798",13097.834154318,61799.6464226905,61,108,0.521151668857783,47,22.5058715636842,"Q3"
"2278","799",12290.3276195595,61820.2988510955,48,91,0.742187178693712,43,11.0859513161704,"Q4"
"2279","8",14469.8287036239,61779.9714273446,52,94,0.370315789245069,42,26.4467368517071,"Q2"
"2280","80",22399.5162496103,61597.5775463169,50,124,0.014040500856936,74,72.9610029365867,"Q1"
"2281","800",12340.179614754,61814.7952361505,46,87,0.593019109917805,41,16.68621649337,"Q3"
"2282","801",16819.9839107292,61745.0692593774,56,100,0.15155343990773,44,37.3316486440599,"Q1"
"2283","802",15628.4268620436,61761.8091018361,57,99,0.263155912281945,42,30.9474516841583,"Q2"
"2284","803",12315.6940032076,61820.5334665135,63,95,0.708555524237454,32,9.32622322440147,"Q4"
"2285","804",13334.4200122225,61801.0358507246,63,95,0.429168414324522,32,18.2666107416153,"Q3"
"2286","805",15394.4844565218,61778.9671225717,51,83,0.136240862542763,32,27.6402923986316,"Q2"
"2287","806",12290.3421608161,61821.570517471,55,97,0.785685427021235,42,9.00121206510812,"Q4"
"2288","807",18816.6975074103,61692.3136089059,56,113,0.119336380856112,57,50.1978262912016,"Q1"
"2289","808",15188.7996245755,61750.4065289023,54,118,0.442382108885795,64,35.6875450313091,"Q2"
"2290","809",12239.4617212647,61823.0979234233,48,99,0.856625557877123,51,7.31209654826671,"Q4"
"2291","81",15653.0652083253,61716.6740536765,98,155,0.461227462626994,57,30.7100346302614,"Q1"
"2292","810",14422.7466104357,61787.0448226504,58,90,0.283139053964987,32,22.9395502731204,"Q2"
"2293","811",12099.5869545818,61826.3224652736,54,92,0.97337788506411,38,1.01164036756381,"Q4"
"2294","812",12820.6179906925,61808.1860731605,71,146,0.745994129218161,75,19.0504403086379,"Q3"
"2295","813",12305.3091240901,61820.0532611266,56,90,0.690134228905663,34,10.5354362172075,"Q4"
"2296","814",12164.513552523,61825.3016209669,54,102,0.927780253114179,48,3.46654785051942,"Q4"
"2297","815",18115.9942034996,61724.8188274673,45,94,0.103244368685409,49,43.9410259344149,"Q1"
"2298","816",12367.0455303619,61821.5431489639,68,128,0.865562490187585,60,8.06625058874488,"Q4"
"2299","817",15760.6608773639,61729.2001135922,54,127,0.448187908157706,73,40.2822827044874,"Q1"
"2300","818",14661.858277367,61784.8502656714,43,75,0.307160455035046,32,22.1708654388785,"Q2"
"2301","819",12188.1318600023,61821.525539614,36,74,0.793768436415121,38,7.8367994162254,"Q4"
"2302","82",16831.4628011954,61715.4216360821,56,118,0.336755255004391,62,41.1211741897278,"Q1"
"2303","820",12338.7699984093,61820.9968703534,54,108,0.815663606859744,54,9.95416522957385,"Q4"
"2304","821",17203.5122755714,61750.9971145209,53,94,0.0447484992910177,41,39.1653115290683,"Q2"
"2305","822",14242.3374306775,61783.2903494489,45,88,0.415053269593045,43,25.1527094074991,"Q2"
"2306","823",16785.6827747577,61742.3550867106,58,103,0.17306577344425,45,37.2120401950087,"Q1"
"2307","824",12110.8642003611,61826.3224652736,61,99,0.96608483674936,38,1.28877620352432,"Q4"
"2308","825",12452.9060614991,61817.2242096518,70,109,0.68778505246155,39,12.1763829539996,"Q3"
"2309","826",15392.159605439,61780.3438032524,48,79,0.12701325956732,31,27.0625889534131,"Q2"
"2310","827",15854.5020222567,61732.4300650976,50,119,0.423502479679883,69,39.7783289020881,"Q1"
"2311","828",12573.6881449423,61812.0503501873,63,111,0.630997433094308,48,17.7121232114732,"Q3"
"2312","829",15773.2301627064,61723.8207505922,62,136,0.467501913430169,74,39.4048584061675,"Q1"
"2313","83",19301.3805967624,61664.1548301623,61,123,0.141196814365685,62,53.2457975093275,"Q1"
"2314","830",19267.9932477261,61695.1623951327,61,115,0.0310758827254176,54,52.3219023328274,"Q1"
"2315","831",15128.6848187007,61761.9804092932,62,110,0.375955064315349,48,29.9541569128633,"Q2"
"2316","832",19833.439776516,61635.7955584811,53,124,0.186882351525128,71,57.7313530417159,"Q1"
"2317","833",18128.5288508865,61698.635536826,49,109,0.221606561914086,60,46.7036062851548,"Q1"
"2318","834",12463.1545533995,61818.3859109218,55,122,0.807137796655297,67,12.9217676240951,"Q3"
"2319","835",12398.53609406,61815.739591004,57,93,0.589785149553791,36,14.7677346160635,"Q3"
"2320","836",12182.3984450508,61824.4607995406,58,91,0.865330427186564,33,4.4440959028434,"Q4"
"2321","837",14104.2461527881,61791.7163304784,52,84,0.317592148436233,32,21.8370512500405,"Q2"
"2322","838",12375.5875017622,61818.5331233548,65,98,0.659665292827412,33,11.2310453366954,"Q3"
"2323","839",12182.348838912,61824.8164630368,63,100,0.897661216789857,37,3.78653497877531,"Q4"
"2324","84",12311.3534195886,61822.619226094,48,124,0.893329139566049,76,8.10698539298028,"Q4"
"2325","840",12286.0327436015,61820.802941182,58,89,0.697325014043599,31,9.38292456464842,"Q4"
"2326","841",12301.6693917745,61818.7794166785,50,86,0.654177619842812,36,12.4496056856588,"Q3"
"2327","842",12415.8507046505,61815.0150404085,46,99,0.673224060563371,53,17.3191247901414,"Q3"
"2328","843",12455.4866610204,61813.669479457,59,96,0.561244761571288,37,16.2339438218623,"Q3"
"2329","844",12082.6003346119,61826.3224652736,64,130,0.998294379329309,66,0.112570964265615,"Q4"
"2330","845",12142.8658684537,61826.0225272629,51,110,0.95705575752072,59,2.5337103062775,"Q4"
"2331","846",12481.4359454412,61817.9184860344,53,124,0.808241023914889,71,13.6148873020429,"Q3"
"2332","847",16606.0067138011,61705.6916299298,57,130,0.412813941715285,73,42.8645822547842,"Q1"
"2333","848",12300.7067805826,61814.5060159025,42,75,0.553366343490779,33,14.7389106648043,"Q3"
"2334","849",12349.2000037364,61816.6287677115,50,89,0.620221099583432,39,14.8113771162461,"Q3"
"2335","85",13301.9325983269,61800.4649539612,80,111,0.469143772032112,31,16.4565430670045,"Q3"
"2336","850",12667.48817662,61808.5709342585,66,113,0.586542777717113,47,19.4324894472957,"Q3"
"2337","851",18452.7219602897,61720.2256416306,38,86,0.109493884025142,48,42.7442935667932,"Q1"
"2338","852",12464.8167789952,61815.8384238803,58,105,0.677591720828786,47,15.153189121047,"Q3"
"2339","853",15073.0672657232,61764.17835845,61,108,0.371078822063282,47,29.5592953630257,"Q2"
"2340","854",12101.0193220852,61826.3224652736,53,94,0.973950027022511,41,1.06804889207706,"Q4"
"2341","855",13133.5277301987,61793.5526527756,61,130,0.584761502221227,69,28.6514563467354,"Q2"
"2342","856",12103.593482563,61826.3224652736,54,91,0.966946658911183,37,1.22297362028621,"Q4"
"2343","857",15853.8343165608,61760.5765494145,63,102,0.205673241522163,39,30.9787435806356,"Q2"
"2344","858",13649.4288789725,61794.9864265144,71,104,0.420574938878417,33,19.1210270170122,"Q2"
"2345","859",15975.6705400034,61770.2188362821,48,83,0.116824962431565,35,30.9111263148952,"Q2"
"2346","86",20479.4556798978,61610.4950382536,57,130,0.157975813606754,73,61.467765606707,"Q1"
"2347","860",12330.2961329405,61821.4749059132,75,111,0.792732001515105,36,7.46164794545621,"Q4"
"2348","861",12290.4437862881,61821.0104419576,56,92,0.7363884402439,36,9.49001615121961,"Q4"
"2349","862",14251.1293578347,61784.2443013687,62,100,0.376622623531148,38,23.6883403058164,"Q2"
"2350","863",12493.5080616679,61816.7564924839,55,117,0.761769188567996,62,14.7703103087842,"Q3"
"2351","864",12354.7726847099,61818.6555195312,61,94,0.651538181584328,33,11.4992400077172,"Q3"
"2352","865",16070.9903604171,61740.3343472123,55,110,0.340895306318998,55,36.2507581524551,"Q1"
"2353","866",17008.909017953,61715.9395062739,46,109,0.341293937992305,63,41.4984819064848,"Q1"
"2354","867",14824.6402759804,61762.6491054382,66,119,0.439063650090247,53,29.7296265452169,"Q2"
"2355","868",20174.3021337611,61661.9065819471,53,116,0.0666335511486977,63,58.802086277632,"Q1"
"2356","869",12454.63680258,61814.4885233458,44,106,0.707433483330533,62,18.139124033507,"Q3"
"2357","87",14346.2359670032,61778.7906983348,68,110,0.412741429870948,42,24.6648599454202,"Q2"
"2358","870",12107.1528046124,61826.3224652736,49,102,0.975501328473911,53,1.29842959088273,"Q4"
"2359","871",16349.5040330144,61757.8860469074,71,107,0.092263272497803,36,32.6785221900791,"Q2"
"2360","872",12528.0134706655,61817.4502235639,63,134,0.819865013007075,71,12.7895840764977,"Q3"
"2361","873",21183.0035558439,61616.8633597815,49,121,0.093357055913657,72,65.2782919742167,"Q1"
"2362","874",20394.9308026251,61593.803741508,68,140,0.165144608588889,72,60.1095881816,"Q1"
"2363","875",12321.0789015026,61820.2095756504,56,95,0.729549350449815,39,10.5475753324572,"Q4"
"2364","876",12276.3950216745,61822.8575486338,66,108,0.844626614125445,42,6.52568220673129,"Q4"
"2365","877",12422.9047085925,61816.3717477065,51,101,0.689153586747125,50,15.5423206626438,"Q3"
"2366","878",19175.4353693086,61694.1638076393,49,106,0.0869627667125314,57,52.0431222973857,"Q1"
"2367","879",18953.6722158155,61704.272858651,57,110,0.0458128028549254,53,50.571921448689,"Q1"
"2368","88",12331.8532344845,61820.943473101,58,104,0.790861411485821,46,9.62037507165223,"Q4"
"2369","880",12350.350984146,61819.4013790998,59,97,0.706530896713957,38,11.1518259248696,"Q4"
"2370","881",12096.6305141691,61826.3224652736,69,127,0.991160579025745,58,0.512686416506767,"Q4"
"2371","882",17126.1645796339,61700.6387533553,57,124,0.35115414718166,67,43.4726721388288,"Q1"
"2372","883",12183.7095629654,61823.4706386526,42,86,0.851941941073164,44,6.51455459278077,"Q4"
"2373","884",15597.1692678113,61752.9041435956,61,110,0.342179657891393,49,32.2331967633218,"Q2"
"2374","885",15488.3628383927,61760.7381086034,62,105,0.297636859118938,43,30.2016150578856,"Q2"
"2375","886",15986.807265775,61720.8066713452,85,141,0.406537877162918,56,33.2338788788766,"Q1"
"2376","887",18935.3496859179,61713.6747425567,55,106,0.011688181431964,51,50.4039027469698,"Q1"
"2377","888",13259.229906187,61797.4677385522,57,102,0.490280152065679,45,22.9373931570444,"Q3"
"2378","889",15199.3201007225,61764.7751463496,58,103,0.337994309840724,45,29.7902560571674,"Q2"
"2379","89",13335.3254123929,61799.6027267179,66,101,0.457823093282059,35,18.9761917351279,"Q3"
"2380","890",14057.0709597745,61772.9070896798,51,118,0.498283237218857,67,33.6150231063366,"Q2"
"2381","891",12533.4811974211,61815.3035982811,54,118,0.743960900930688,64,16.386502340436,"Q3"
"2382","892",18201.7979007043,61708.6024577757,58,111,0.129703225335106,53,46.1257290572394,"Q1"
"2383","893",12343.6400601686,61822.5956592627,73,146,0.912509560352191,73,6.38680209429003,"Q4"
"2384","894",13745.5952471991,61779.9831112289,57,123,0.52603898732923,66,31.2814268362708,"Q2"
"2385","895",12385.575370198,61818.7972197714,60,102,0.718443247489631,42,11.8253836054355,"Q3"
"2386","896",18620.9670359185,61725.1390971384,38,84,0.0514998307917267,46,43.6310077835806,"Q1"
"2387","897",16466.8051997143,61762.1160124421,67,102,0.042577404063195,35,33.5097908577882,"Q2"
"2388","898",18498.3205634503,61706.2434959751,54,108,0.109456168720499,54,48.0893668890931,"Q1"
"2389","899",18250.9569036613,61695.8303893763,70,123,0.139574089553207,53,45.60257325368,"Q1"
"2390","9",15320.4967301329,61756.5392848641,52,106,0.384320544078946,54,33.2466906197369,"Q2"
"2391","90",13833.5426258408,61795.1433570537,47,79,0.363884738879278,32,20.3556883558631,"Q2"
"2392","900",12409.2594093667,61816.1683131163,57,96,0.625587886665016,39,14.6020724200644,"Q3"
"2393","901",16525.7884941757,61761.3324849567,48,86,0.0943647525273263,38,34.4141394039616,"Q2"
"2394","902",15234.1596115005,61777.260371745,53,87,0.196487890556455,34,27.3194117210805,"Q2"
"2395","903",15029.7736615654,61768.98753567,59,102,0.33788057230413,43,28.4711353909224,"Q2"
"2396","904",12110.9498920277,61826.3224652736,57,132,0.986811927054077,75,0.989105470944196,"Q4"
"2397","905",12099.8534796585,61826.3224652736,58,90,0.96912756934762,32,0.98791778087616,"Q4"
"2398","906",12650.1163789211,61811.0975110235,63,121,0.677250419510528,58,18.7194756683894,"Q3"
"2399","907",13293.3649789302,61794.0932942861,62,115,0.529233985580504,53,24.9505987642333,"Q2"
"2400","908",12353.2993644352,61821.0902147861,53,115,0.840238475473598,62,9.90521452063695,"Q4"
"2401","909",14510.6456713733,61785.8194908171,38,71,0.411536829778925,33,19.4192846172955,"Q2"
"2402","91",15957.0083833334,61733.0796934385,70,126,0.382853110553697,56,34.560225808993,"Q1"
"2403","910",13604.2484038185,61786.8554176634,75,128,0.542387921828777,53,24.2534401430748,"Q2"
"2404","911",14118.6404249863,61782.2951838576,54,101,0.430709530832246,47,26.7566520508844,"Q2"
"2405","912",12528.6297265183,61811.9306725074,60,104,0.590485497144982,44,18.0186381256208,"Q3"
"2406","913",12555.9652641787,61816.4159807829,86,141,0.799535637721419,55,11.0255399253219,"Q3"
"2407","914",12302.4037085297,61822.7593178519,63,119,0.875668859342113,56,6.96254387684166,"Q4"
"2408","915",13886.7312154255,61794.4507474609,51,83,0.343752187443897,32,20.9999300017953,"Q2"
"2409","916",17952.3525722,61704.4716513931,60,115,0.183758597820997,55,44.8932771198452,"Q1"
"2410","917",13596.9812926806,61793.1212753283,57,99,0.45090433373116,42,23.0620179832913,"Q2"
"2411","918",17067.2597441106,61712.1192481296,68,123,0.278472936246544,55,39.6839885064401,"Q1"
"2412","919",15819.1767542896,61750.4938147729,52,103,0.327759250998497,51,34.2842781990767,"Q2"
"2413","92",19630.6684735451,61636.8919130601,55,126,0.203052625060081,71,56.5832636207342,"Q1"
"2414","920",12173.9431250938,61826.0104386486,56,130,0.959888169774786,74,2.96827543666586,"Q4"
"2415","921",15820.5048862978,61768.319225846,61,96,0.136944710277021,35,30.2069351403043,"Q2"
"2416","922",14825.1980058867,61777.4137971097,55,93,0.302650222554803,38,26.4992915429175,"Q2"
"2417","923",12370.321488143,61811.9664298627,46,88,0.546315102605149,42,19.0547656905837,"Q3"
"2418","924",15683.8428602393,61750.5527404551,65,113,0.33324923273176,48,32.0040368288755,"Q2"
"2419","925",16722.215601081,61739.9434062508,49,98,0.233077155658975,49,37.5792193727102,"Q1"
"2420","926",15744.4041823833,61760.2844532076,47,91,0.283868052531034,44,31.5098056886345,"Q2"
"2421","927",19393.8799215799,61676.9947289612,52,113,0.114688159199432,61,54.0040222888347,"Q1"
"2422","928",12301.4650847827,61817.8574538198,49,84,0.61861933581531,35,13.3483232464641,"Q3"
"2423","929",12082.0817359524,61826.3224652736,61,94,0.995652890065685,33,0.143454627832398,"Q4"
"2424","93",12418.7535177506,61815.6058179739,44,103,0.713069618213922,59,16.9288925253786,"Q3"
"2425","930",13024.2124928302,61803.5402735328,53,91,0.470395825104788,38,20.1249586460181,"Q3"
"2426","931",13559.2604825032,61797.1209061215,50,85,0.402269734069705,35,20.9205593075603,"Q2"
"2427","932",14823.1695674738,61776.3504576405,56,95,0.314830008894205,39,26.721629653126,"Q2"
"2428","933",12574.4406264692,61812.002453989,67,111,0.614189167739823,44,16.9756766194478,"Q3"
"2429","934",12132.7724528702,61825.6733914964,59,91,0.927778959041461,32,2.31107331067324,"Q4"
"2430","935",15050.1567401659,61778.0058632467,38,72,0.3508631514851,34,22.0706528495066,"Q2"
"2431","936",13835.2081947513,61786.3713455695,82,122,0.478982734261081,40,20.8406906295568,"Q2"
"2432","937",14498.0066070263,61786.1585478389,58,90,0.273122362326831,32,23.2600844055414,"Q2"
"2433","938",14138.9101962332,61789.3414121806,57,91,0.340497132623568,34,22.4230974907987,"Q2"
"2434","939",17275.0784759891,61706.0619077535,64,122,0.282561576226726,58,41.6114285788499,"Q1"
"2435","94",16608.5903502834,61762.9803094473,53,90,0.0475112507119775,37,35.2420837236568,"Q2"
"2436","940",12489.3507778712,61813.8936707079,49,106,0.677990885684267,57,18.3545195159968,"Q3"
"2437","941",12089.4147091821,61826.3224652736,48,111,0.992972740670666,63,0.442717337748036,"Q4"
"2438","942",12720.9045372175,61805.5291275518,54,119,0.620997606078163,65,24.6351556049194,"Q3"
"2439","943",15025.8883658823,61780.4617812085,53,86,0.209674440557137,33,26.0807434616145,"Q2"
"2440","944",13185.5217761748,61797.9713775954,55,102,0.497643013251945,47,23.6107783771586,"Q3"
"2441","945",12587.0373389095,61815.9482426918,73,141,0.810886653838679,68,12.8597075389698,"Q3"
"2442","946",15022.1707752894,61753.9832731674,75,129,0.449598925886676,54,29.7216580021195,"Q2"
"2443","947",19809.013217315,61609.9850703675,59,135,0.236559760989621,76,58.0214581647888,"Q1"
"2444","948",12197.2317612558,61824.8061138544,54,109,0.919345444301143,55,4.43600056343712,"Q4"
"2445","949",12438.8155560297,61812.0946865088,49,95,0.579488255549222,46,19.3435402447358,"Q3"
"2446","95",13375.4810920676,61797.4005133907,66,105,0.477329346584156,39,20.3841554832179,"Q3"
"2447","950",18430.2358478532,61717.9469129208,50,101,0.07420724327676,51,47.2154305928852,"Q1"
"2448","951",12143.8646222698,61825.3035108833,46,90,0.921012795995921,44,3.47543697617948,"Q4"
"2449","952",17033.6703100649,61706.5152569273,58,122,0.339271913981065,64,42.2865975052118,"Q1"
"2450","953",12845.5236322277,61804.7468230557,71,134,0.654714171309024,63,21.7530072075315,"Q3"
"2451","954",13945.9351424999,61776.7811313231,60,123,0.515398117247969,63,30.529918613378,"Q2"
"2452","955",15230.3095411047,61760.4713438277,75,117,0.339119055541232,42,27.7569996672682,"Q2"
"2453","956",14744.34469392,61773.2734587227,49,95,0.376942170085385,46,28.6606601760723,"Q2"
"2454","957",12810.0143368286,61807.7556758552,64,100,0.514090570621192,36,17.4927394576371,"Q3"
"2455","958",12464.3128822708,61816.9950528377,66,110,0.70468143792823,44,12.9940167311579,"Q3"
"2456","959",15137.4421879982,61766.8883455862,63,105,0.325446220580488,42,28.3312587356195,"Q2"
"2457","96",21095.4251259386,61629.1286887385,62,128,0.0268993927165866,66,64.2246400807053,"Q1"
"2458","960",12162.078783712,61822.7970176236,36,77,0.836567868944257,41,6.70071737328544,"Q4"
"2459","961",19034.0269766657,61664.9970847218,56,121,0.193110128398985,65,52.447841654066,"Q1"
"2460","962",12373.8367119744,61817.6876300865,61,94,0.623796316795051,33,12.4147215457633,"Q3"
"2461","963",12300.1438574774,61820.8643847388,40,106,0.83836521813646,66,10.6678956029937,"Q4"
"2462","964",19499.0250386284,61643.0005137603,57,126,0.19583875220269,69,55.4871260980144,"Q1"
"2463","965",19935.2106330862,61631.4087123402,45,119,0.225783427711576,74,57.2920263493434,"Q1"
"2464","966",12348.08480734,61821.2925566875,65,114,0.824211511993781,49,8.61363591230474,"Q4"
"2465","967",12121.1060335564,61826.3224652736,45,112,0.973064759047702,67,1.80466114380397,"Q4"
"2466","968",22208.8282503134,61592.8576241116,57,130,0.0163664715364575,73,71.8052475778386,"Q1"
"2467","969",12402.8340381323,61814.398131662,50,93,0.601650303695351,43,17.1290369410999,"Q3"
"2468","97",12335.1092250052,61821.505934906,68,112,0.816411679843441,44,8.07788608688861,"Q4"
"2469","970",12634.2667712968,61805.8242115492,38,106,0.643739097518846,68,24.2257413687184,"Q3"
"2470","971",18271.5676417188,61690.0465175689,62,120,0.191112871747464,58,46.9154534386471,"Q1"
"2471","972",12168.4643657849,61825.0958507269,68,100,0.903390850871801,32,3.09149277210236,"Q4"
"2472","973",15885.6955590482,61770.9289392577,50,85,0.12218352383934,35,30.7235766656231,"Q2"
"2473","974",14442.6021638334,61783.4333570685,55,92,0.333553059957922,37,24.6585367815569,"Q2"
"2474","975",12433.0248323213,61815.8617082206,54,100,0.66120821563527,46,15.5844220807776,"Q3"
"2475","976",20585.1251325449,61589.9924699351,58,135,0.188603130634874,77,62.4775589411147,"Q1"
"2476","977",15120.8625078617,61770.0824740487,72,108,0.274075192632154,36,26.1332930652425,"Q2"
"2477","978",16247.6608086322,61736.6501039406,58,112,0.323698756983504,54,36.5202671228908,"Q1"
"2478","979",12929.8143477539,61801.7414853893,70,139,0.65521540818736,69,23.7901368350722,"Q3"
"2479","98",12504.6194109293,61813.0954834804,64,102,0.575396955246106,38,16.134915700648,"Q3"
"2480","980",13834.500043024,61784.293881691,59,111,0.482913326239213,52,26.8885070355609,"Q2"
"2481","981",17310.7490744335,61736.0196565071,52,99,0.138221064815298,47,40.503609953681,"Q1"
"2482","982",16808.3015391865,61752.9388729479,58,98,0.0848984490148723,40,36.6040620394051,"Q2"
"2483","983",12119.3357618847,61826.1186587437,59,97,0.956058259354904,38,1.66978614451364,"Q4"
"2484","984",15526.0209391573,61726.1644595496,65,142,0.494996957713738,77,38.8852342560422,"Q1"
"2485","985",12593.4801816344,61811.1807310814,60,96,0.529479902237654,36,16.9387235194445,"Q3"
"2486","986",12446.3314401917,61819.0981063698,81,127,0.79514153371565,46,9.42348944908008,"Q4"
"2487","987",16446.927052432,61753.7046779621,73,110,0.101757169235498,37,33.2349847382866,"Q2"
"2488","988",17957.7480182774,61721.0234326377,63,111,0.086573705310002,48,43.8444621451199,"Q1"
"2489","989",12304.4319158655,61819.4192860079,52,88,0.676508362637833,36,11.645698945038,"Q4"
"2490","99",12903.1553014453,61807.0742080671,56,89,0.465717924991623,33,17.6313084752765,"Q3"
"2491","990",21641.4944769619,61569.7347465538,68,141,0.0737154099624604,73,67.6187750727404,"Q1"
"2492","991",14671.5456847247,61780.6807170119,61,96,0.295861506368965,35,24.6448472770862,"Q2"
"2493","992",18237.7021382012,61683.5831123562,57,120,0.239974872674793,63,47.881583021488,"Q1"
"2494","993",17506.207647171,61733.4561004434,54,101,0.114881644025445,47,41.6005627308041,"Q1"
"2495","994",12163.2032472758,61825.1508278147,63,97,0.90641833958216,34,3.18177645420656,"Q4"
"2496","995",15592.4035816266,61768.004743781,59,96,0.202078134985641,37,29.5231090055313,"Q2"
"2497","996",12185.0835783672,61826.0207402803,66,139,0.960892274277285,73,2.85486397775821,"Q4"
"2498","997",12557.8448329036,61815.3585789268,70,123,0.734282018383965,53,14.0830530256499,"Q3"
"2499","998",16927.1572425697,61717.3312252185,63,119,0.292289311299101,56,39.6317985672504,"Q1"
"2500","999",12304.9828669387,61818.1677583683,52,84,0.60400528460741,32,12.6718308925629,"Q3"
"2501","coordinated",1082.67022669729,61629.4184954947,NA,NA,NA,NA,NA,"Q1"
"2502","decentralized",12078.6733027295,61826.3224652737,NA,NA,NA,NA,NA,"Q4"
